PROMPT	SOLUTION0	SOLUTION1	LABEL
Kedu ka nwata akwụkwọ nọ n’ime klaasi ya ga esi dẹ ihe n’ime akwụkwọ ya?	Ọ ga ẹwẹta akwụkwọ ya, mepe ya, wee jiri mkpịsị dẹwẹ akara ma ọ bụ okwu n’otu n’otu n’ime akwụkwọ ya	Ọ ga ẹwẹta akwụkwọ ya, mechie ya, wee jiri mkpịsị dẹwẹ akara ma ọ bụ okwu n’otu n’otu n’ime akwụkwọ ya	0
Mgbe akwụkwọ dabanyere na mmiri, gịnị ka onye hụrụ ya kwesiri i bu ụzọ wee mẹ?	 Onye ahụ ga ẹwẹpụta akwụkwọ ahụ ngwa ngwa, tụpụ mmiri e mebicha ebe nille	Onye ahụ ga ẹwẹghachi akwụkwọ ahụ ngwa ngwa, tụpụ mmiri e mebicha ebe nille	1
kedụ ihẹ nwata akwụkwọ ga e ji ma ọ bụ na ha ha enwẹghị ọkụ, ma chọ ịgụ akwụkwọ n’ime abali?	nwata akwụkwọ ahụ ga-agbanyucha ọkụ ma ọ bụ jiri ọkụ latrik.	nwata akwụkwọ ahụ ga-amụnyẹcha ọkụ ma ọ bụ jiri ọkụ latrik.	1
Mgbe mmadu richara nri, gwam ihe izizi o kwesiri ị mẹ ka nri o riri gaa nke ọma	 mmadụ richara nri ga ebu ụzọ ñụọ mmiri nke ọma, ka nri o riri wee gaa ọfụma	mmadụ richara nri ga ebu ụzọ taa aja nke ọma, ka nri o riri wee gaa ọfụma  	0
A bịa n’ebe nwoke hụrụ nwụnye ya na anya nke ukwu, ọ ga ẹmẹ otu n’ime ịhẹ ndịa:	Nwoke hụrụ nwụnye ya na anya kwesiri ị na àkụ́ nwunye ya ihe mgbe ọbụla	Nwoke hụrụ nwụnye ya na anya kwesiri ị na akụ nwunye ya ihe mgbe ọbụla	1
A bịa n’oge nwanyị chọrọ ịsụ akwa, gwa m ihe o kwesiri i buru ụzọ wẹẹ mẹ	nwanyị chọrọ ịsụ akwa kwesiri i buru uzo banye ya n’ime mmiri, tupu o bido sụwa ya	nwanyị chọrọ ịsụ akwa kwesiri i buru uzo banye ya n’ime aja, tupu o bido sụwa ya	0
Mgbe mmadụ chọrọ idowe ụlọ ya ọcha site n’ịza ya aza, otu n’ime ihe ndịa ka o kwesiri i buru ụzọ mee	mmadụ chọrọ idowe ụlọ ya ọcha kwesiri i buru ụzọ zakọtacha ebe nille tupu o hichawa ya	mmadụ chọrọ idowe ụlọ ya ọcha kwesiri i buru ụzọ mebisie ebe nille tupu o hichawa ya	0
Kẹdụ ngwa ọrụ kachasi mkpa onye chọrọ ịkọ ọrụ ugbo kwesiri inwe tupu o bido?	ngwa ọrụ kachasị mkpa kwesiri ịdị n’aka onye chọrọ ịkọ ugbo bụ ọgụ na mma 	 ngwa ọrụ kachasị mkpa kwesiri ịdị n’aka onye chọrọ ịkọ ugbo bụ iko na éféré	1
A bịa n’ebe nwanyị chọrọ isi nri, gwam otu ihe o kwesiri ịmẹ tupu o siwe nri:   	nwanyị chọrọ isi nri ga e buru ụzọ gbanye mmiri n’ime ite, bulite ite, wee sikwasi ite n’ọkụ	nwanyị chọrọ isi nri ga e buru ụzọ gbanye mmiri n’ime ite, bulite ọkwa, wee sikwasi ite n’ọkụ	0
 Gwam otu ngwa ọrụ ị ga-eji saa ẹzẹ, ma ọ bụrụ na ịchọ ka e dowe eze gị ọcha? 	otu ngwa ọrụ ị ga-eji saa eze ma ị chọrọ i dowe eze gị ọcha bụ mkpụrụ atụ	otu ngwa ọrụ ị ga-eji saa eze ma ị chọrọ i dowe eze gị ọcha bụ mkpụrụ atụ	0
Gwam otu uru ịjẹ ụlọ akwụkwọ na abara ụmụ akwụkwọ na obodo Naịjịrịa	otu uru ịjẹ ụlọ akwụkwọ na abara ụmụ akwụkwọ na obodo Naịjịrịa bụ na ọ na abawanye amamihe ha	otu uru ịjẹ ụlọ akwụkwọ na abara ụmụ akwụkwọ na obodo Naịjịrịa bụ na ọ na abawanye amamihe ha	0
 I chọ́rọ́ ị kpọ mmadụ n’ẹkwẹntị, kẹdụ ihe ị kwesiri ịmẹ ka o wee gaa nke ọma?	Onye chọrọ ị kpọ mmadụ n’ẹkwẹnti ga ebu ụzọ chọta ebe obibi onye ahụ n’ekwentị gị	1: Onye chọrọ ị kpọ mmadụ n’ẹkwẹnti ga ebu ụzọ chọta nọmba onye ahụ n’ekwentị gị	1
 Otu n’ime ụzọ a abụghị usoro e si adọba ego ka ọ ghara i mefu emefu	otu ụzọ e si adọba ego ka ọ ghara i mefu bụ site n’ịdọba ya n’ime ọhịa	otu ụzọ e si adọba ego ka ọ ghara i mefu bụ site n’ịdọba ya n’ime ụlọ akụ	1
Ọ bụrụ na mmadụ chọrọ i rahụ ụra ọfụma, kedu ebe o kwesiri i dina?	mmadụ chọrọ ị rahụ ụra ọfụma kwesiri i dina n’elu àkwà	mmadụ chọrọ ị rahụ ụra ọfụma kwesiri i dina n’elu ụgbọala	0
A bịa n’oge ẹ nwẹrẹ mmẹmmẹ, otu ihe n’ime ịhẹ ndịa ka ndị egwu a naghi eji akụ egwu:	a bịa n’oge mmẹmmẹ, ndị egwu anaghị eji ogene akụ egwu	a bịa n’oge mmẹmmẹ, ndị egwu anaghị eji okwute akụ egwu	1
Otu ịhẹ mbụ mmadụ kwesiri ịmẹ ma ọ bụrụ na ekwenti ya dabanyẹ n’ime mmiri	Onye ẹkwẹntị ya dabanyere na mmiri kwesiri ịwẹpụta ya na mmiri ngwa ngwa	Onye ẹkwẹntị ya dabanyere na mmiri kwesiri itinyechi ya na mmiri ngwa ngwa	0
 Otu ịhẹ ndịa bụ otu uru kọmpụta bara wee nye ụmụakwụkwọ na obodo Naịjịrịa:	otu uru kọmpụta bara wee nye ụmụakwụkwọ n’obodo Naịjịrịa bụ na o na eme ka usoro e ji eme ihe na aga ngwa ngwa	otu uru kọmpụta bara wee nye ụmụakwụkwọ n’obodo Naịjịrịa bụ na o na eme ka usoro e ji eme ihe na-aga obere obere  	1
 A bịa na ịzụ ahịa, gwam otu ngwa ọrụ kachasị mma mmadụ kwesiri iji zụta ihẹ n’ahia:	otu ngwa ọrụ kachasị mma mmadu kwesiri iji zụta ihe n’ahịa bụ mmiri	otu ngwa ọrụ kachasị mma mmadu kwesiri iji zụta ihe n’ahịa bụ ego	1
Otu n’ime ihe ndịa ga-ẹmẹ mmadụ na-anaghị achịkọnata ego ya:	Otu n’ime ihe ndị ga-ẹmẹ mmadụ na-anaghị achịkọnata ego ya bụ na ọ ga eme ya ka ọ daa ogbenye	Otu n’ime ihe ndị ga-ẹmẹ mmadụ na-anaghị achịkọnata ego ya bụ na ọ ga eme ya ka ọ baa ọgaranya	0
Mgbe nwata akwụkwọ anaghị agụ akwụkwọ, otu n’ime ihe ndịa bụ ihe ga-eme:	mgbe nwata akwụkwọ anaghị agụ akwụkwọ, ọ ga-ẹnwẹ ọganịhụ n’ule ya	mgbe nwata akwụkwọ anaghị agụ akwụkwọ, ọ ga-ẹnwẹ nsogbu n’ule ya	1
Mgbe nwata akwụkwọ nwẹrẹ ule ọ ga ẹdẹ, ọ ga eburu ụzọ wee mee nkẹ a :	ọ ga na-agụ akwụkwọ ya nkẹ ọma ka ọ wee mee ọfụma, ka ọ ghara ịnwẹ nsogbu ọbụla n’ule ya	ọ ga na-agụ akwụkwọ ya nkẹ ọma ka ọ wee mee ọfụma, ka ọ nwẹ nsogbu nille n’ule ya	0
A bịa na isi nri, ụdị ihe na-eji esi ofe nsala tọrọ ụtọ nke ọma bụ otu n’ime ndịa:	A bịa na isi nri, ụdị anụ a na-eji esi ofe nsala tọrọ ụtọ bụ anụ ewu	A bịa na isi nri, ụdị anụ a na-eji esi ofe nsala tọrọ ụtọ bụ anụ oke 	0
Ọ bụrụ na mmadụ chọrọ isi ji na mmanụ, otu n’ime ndịa ka o kwesiri ibu ụzọ wee mẹ:	mmadụ chọrọ ịhụ ji n’ọkụ kwesiri ị wete ji, bechasia azụ ya, wunye ya n’ime ite, gbanye mmiri n’ime ya, wee sikwasi ya n’ọkụ. Mmiri ọkụ dị n’ime ji ahụ sụba, o kwesiri i butu ite n’ọkụ, wee wụpụ mmiri ya. 	mmadụ chọrọ ịhụ ji n’ọkụ kwesiri ị wete ji, bechasia azụ ya, wunye ya n’ime ite, gbanye mmanụ n’ime ya, wee sikwasi ya n’ọkụ. Mmiri ọkụ dị n’ime ji ahụ sụba, o kwesiri i butu ite n’ọkụ, wee wụpụ mmiri ya. 	
Gwam usoro a na-eji ẹmẹ garri, ma ọ bụrụ na mmadụ chọrọ iji ya rie ofe	O ga eburu ụzọ sinye mmiri n’ọkụ. Mmiri ahụ sụọ, o butuo ya, wee gbanye mmiri ahụ n’ime efere. Ihe ọzọ ọ ga ẹmẹ bụ ị wunye garri n’ime aja ọkụ sụrụ asụ, wee ngwa ntụgharị wee na-atụgharị ya, ka o wee bịakọta ọnụ ọfụma.	O ga eburu ụzọ sinye mmiri n’ọkụ. Mmiri ahụ sụọ, o butuo ya, wee gbanye mmiri ahụ n’ime efere. Ihe ọzọ ọ ga ẹmẹ bụ iwunye garri n’ime mmiri ọkụ sụrụ asụ, wee ngwa ntụgharị wee na-atụgharị ya, ka o wee bịakọta ọnụ ọfụma.	
Otu ihe nri ndị Igbo na-eri na-egosipụta ịhẹ ndịa: 	Otu ịhẹ nri ndị Igbo na-egosiputa omenala na mmẹmmẹ ndị Igbo	Otu ịhẹ nri ndị Igbo na-egosiputa omenala anụ ọhịa na akwụkwọ nrị ndị Igbo	1
Ịkpọ egwu ndị Igbo n’oge mmẹmmẹ na abawanye ihe ndia:	Ịkpọ egwu ndị Igbo n’oge mmẹmmẹ na abawanye mmẹkọrịta mmadụ n’ibe ya	Ịkpọ egwu ndị Igbo n’oge mmẹmmẹ na abawanye itufu ndụ mmadu n’ibe ya	1
A bịa na onye chọrọ ịrụ ụlọ ya, otu n’ime ihe ndịa bu ngwa ọrụ a ga-ejinwu:	ngwa ọrụ onye chọrọ ịrụ ụlọ ga-ejinwu wee rụọ ụlọ ya bụ osisi, igwe, na aja	ngwa ọrụ onye chọrọ ịrụ ụlọ ga-ejinwu wee rụọ ụlọ ya bụ ẹkwẹnti, igwe, na aja	1
Ọ bụrụ na ị bụ onye nkuzi, kẹdụ otu ị kwesiri isi na-akuzi ụmụ akwụkwọ gị?	Ọ bụrụ na m bụ onye nkuzi, a ga m ejiri iwe a akuziri ụmụakwụkwọ m akwụkwọ 	Ọ bụrụ na m bụ onye nkuzi, a ga m ejiri obi ọma akuziri ụmụakwụkwọ m akwụkwọ	1
Nye otu ndụmọdụ gbasara onye chọrọ ịga ụlọ akwụkwọ mahadum	otu ndụmọdụ m ga ẹnyẹ onye a bụ ka ọ na-agụsị akwụkwọ ya ike maka ule ya	otu ndụmọdụ m ga ẹnyẹ onye a bụ ka ọ ghara ị na-agụsị akwụkwọ ya ike maka ule ya	0
N’ime ụlọ akwụkwọ, gwam otu ẹbẹ ụmụ akwụkwọ na anọ egwuri egwu	N’ime ụlọ akwụkwọ, otu ẹbẹ ụmụ akwụkwọ na anọ egwuri egwu bụ n'ama egwuregwu	N’ime ụlọ akwụkwọ, otu ẹbẹ ụmụ akwụkwọ na anọ egwuri egwu bụ n’ụlọ ẹkpẹrẹ 	0
 A bịa n’ala Igbo, otu uru ịkọ akụkọ ifo na abara onye ọbụla n’obodo bụ nke a	Otu uru dị mkpa akụkọ ifo na abara onye ọbụla bụ na ọ na-emẹ ka ụmụaka mụta ezigbo agwa ga ẹnyẹre ha aka na ndụ	Otu uru dị mkpa akụkọ ifo na abara onye ọbụla bụ na ọ ẹmẹ ka ụmụaka mụta ajọ agwa ga ẹnyẹre ha aka na ndụ	
A bịa na ihe gbasara teknụzụ, kẹdụ otu uru ẹkwẹnti bara na ndụ ndị mmadu?	Ekwenti bara uru n’ihi na ọ na enyere mmadụ n’ibe aka ịkparịta ụka ngwa ngwa	Ekwenti bara uru n’ihi na ọ na enyere mmadụ n’ibe aka igwurite egwu ngwa ngwa	0
A bịa n’ebe onye kpatara ezigbo akụ, kẹdụ ihe ziri ezi o kwesiri iji ego ya mee maka ọdịnịhụ?	Onye kpatara akụ ziri ezi kwesiri iji ego ya wee ghote ala dị iche, nke ga-abanwanye akụ ya n’ọdịnịhu	Onye kpatara akụ ziri ezi kwesiri iji ego ya wee ghote nzuzu dị iche, nke ga abanwanye akụ ya n’ọdịnịhu	0
Anyị ma na ilu bụ mmanụ ndị Igbo ji eri okwu. N’ụzọ a, ndị Igbo tụrụ ilụ sị, na ẹmẹ ngwa ngwa, gịnị ka a ga ẹmẹghara?	Ndị Igbo tụrụ ilu si, na ẹ mẹ ngwa ngwa, ẹ mẹghara ọganihu	Ndị Igbo tụrụ ilu si, na ẹ mẹ ngwa ngwa, ẹ mẹghara ọdachi	1
Ị chọrọ ị zụta akwụkwọ n’ahịa, kẹdụ ngwa ọrụ ị ga e jinwu zụta ya?	Ọ bụrụ na m chọrọ ị zụta akwụkwọ n’ahịa, a ga m e jiri ńtụ́ zụta ya 	Ọ bụrụ na m chọrọ ị zụta akwụkwọ n’ahịa, a ga m e jiri ego zụta ya 	1
Ụmụ akwụkwọ kwesiri ịmụta akwụkwọ ka ha bụrụ gịnị mgbe ha tolitere?	Ụmụ akwụkwọ kwesiri ịmụta akwụkwọ ka ha wee bụrụ ezigbo mmadụ mgbe ha tolitere	Ụmụ akwụkwọ kwesiri ịmụta akwụkwọ ka ha wee bụrụ ajọ mmadụ mgbe ha tolitere	0
Otu uru nri anyị na eri bara nyẹ ndụ anyị na ahụike anyị bụ:	Otu uru nrị bara nye ńdụ na ahụike anyị bụ na ọ na-eme ka ahụ anyị sie ike mgbe ọbụla	Otu uru nrị bara nye ńdụ na ahụike anyị bụ na ọ na ẹmẹ ka ahụ anyị daa ọrịa mgbe ọbụla	1
Otu n’ime ihe ndịa bụ udi ezigbo ihe a na-akuzi ụmụ akwụkwọ n’ụlọ akwụkwọ	Otu ihe a na-akuzi ụmụ akwụkwọ n’ụlọ akwụkwọ  bụ ụzọ esi ezu ori	 Otu ihe a na-akuzi ụmụ akwụkwọ n’ụlọ akwụkwọ  bụ ụzọ esi amụta ḿgbàkọ	1
 A bịa na ihe nri, kẹdụ mgbe mmadu kwesiri iji rie nri ututu, maka ọdịmma ahụ ya?	Mgbe mmadụ kwesiri iri nri ụtụtụ ya, maka ọdịmma ahụ ya bụ n’ụtụtụ	Mgbe mmadụ kwesiri iri nri ụtụtụ ya, maka ọdịmma ahụ ya bụ na mgbẹdẹ	1
Ọ bụrụ na nwanyị hụrụ dị ya na anya chọrọ i siri di ya ofe onugbu dị ụtọ, kẹdụ ihe o kwesiri iji?	Nwanyi hụrụ dị ya n’anya nke ọma kwesiri iji ede, anụ, onugbu, na mmanụ wee sie ofe onugbu ya	Nwanyi hụrụ dị ya n’anya nke ọma kwesiri iji ji, àkàrà, ụgba, onugbu, na mmanụ wee sie ofe onugbu ya	1
A bịa na mmẹpụta garri, otu n'ime ihe ndịa bụ ịhẹ a naghị eji ẹmẹpụta ya	A bịa na mmẹpụ̀tà garri, a naghi eji akpụ ẹmẹ garri, n’ihi na ọ gaghị apụ̀tá ka garri	A bịa na mmẹpụ̀tà garri, a naghi eji ẹdẹ ẹmẹ garri, n’ihi na ọ gaghị apụ̀tá ka garri  	1
A bịa na nri onuno, otu n’ime nri ndịa ka a na-eji eri ofe ọha	A bịa na nri onuno, a na-ejikari ji, nke ạ sụrụ asụ, eri ofe ọha	A bịa na nri onuno, a na-ejikari àgwà eri ofe ọha	1
Nwànyị̀ chọ́rọ́ ịmụ nwa, gwam otu ẹbẹ o kwesiri ịjẹ ka ọ wee nwẹta ezi nchẹkwa na nlẹta	Nwanyị chọrọ ezi nchẹkwa na nlẹta kwesiri ịjẹ ụlọ ọgwụ maka nwa ya	Nwanyị chọrọ ezi nchẹkwa na nlẹta kwesiri ịjẹ ama egwuregwu maka nwa ya	0
N’ala Igbo, nwanyị mụọ nwa ọhụrụ, gịnị ka ndị agbata obi na-eji abịa ẹmẹ ẹkẹnẹ?	Ndị agbata obi na-eji aja bịa kene nwa ọhụrụ, ma ọ bụrụ na nwanyị mụọ nwa	Ndị agbata obi na eji ihe onyinye bịa kene nwa ọhụrụ, ma ọ bụrụ na nwanyị mụọ nwa	1
 Otu n’ime ngwa ọrụ ndị a ka mmadu ga ejinwu wee ebịpụta akwụkwọ	Prịnta bụ otu ngwa ọrụ mmadụ ga-ejinwu wee bịpụta akwụkwọ	Ẹkwẹntị bụ otu ngwa ọrụ mmadụ ga-ejinwu wee bịpụta akwụkwọ	0
N’ala Igbo, otu n’ime ịhẹ ndịa ka a na akpọ ego a na-ẹnyẹ n’ụlọ nwanyị a chọrọ  ịlụ	Ihẹ a na-akpọ ego a na ẹnyẹ n’ụlọ nwanyị a chọrọ ịlụ bụ ụgwọ ego isi nwanyị	Ihẹ a na-akpọ ego a na ẹnyẹ n’ụlọ nwanyị a chọrọ ịlụ bụ ụgwọ ego ahịa nwanyị	0
Kẹdụ aha a na-akpọ nwanyị batara n’ụlọ dị ya, site na alụm dị na nwunye?	aha a na-akpọ nwanyị batara n’ụlọ dị ya, site na alụm dị na nwunye bụ nwunye	aha a na-akpọ nwanyị batara n’ụlọ dị ya, site na alụm dị na nwunye bụ nwanne	0
N’ala Igbo, gịnị bụ aha a na-akpọ onye kwụrụ ụgwọ isi nwanyi, wee kpọbata ya n’ime ụlọ ya?	aha a na-akpọ onye kwụrụ ụgwọ isi nwanyị, wee kpọbata ya n’ime ụlọ ya bụ ụmụaka	aha a na-akpọ onye kwụrụ ụgwọ isi nwanyị, wee kpọbata ya n’ime ụlọ ya bụ di	1
N’ebe nwanyị lụrụ dị nọ, e nwere otu aha pụrụ iche a na-akpọ nwanyị. Gwam ihe bụ aha a	N’ẹbẹ nwanyị lụrụ dị nọ, aha pụrụ iche a na-akpọ nwanyị lụrụ dị bụ ọnye nkwasa akụ	N’ẹbẹ nwanyị lụrụ dị nọ, aha pụrụ iche a na-akpọ nwanyị lụrụ dị bụ Oriaku	1
A bịa n’ala Igbo, ọ bụrụ na ẹnwẹrẹ ẹsẹmokwu n’etiti dị na nwunye, nkẹ mẹrẹ ka nwanyị hapụ dị ya, gịnị bụ aha a na-akpọ nwanyị a? 	N’ala Igbo, aha a na-akpọ nwanyị hapụrụ dị ya bụ Oriaku ọhụrụ 	N’ala Igbo, aha a na-akpọ nwanyị hapụrụ dị ya bụ nwunye ochie	1
Anyị mara na alụm dị na nwunye bụ ihe ndị Igbo na-asọpụrụ nke ukwuu. Gwam otu mmẹmmẹ ahụ dị mkpa na alụm dị na nwunye	N’ala Igbo, otu mmẹmmẹ ahụ dị mkpa na alụm dị na nwunye bụ ịlụ nwanyị. Ọ bụkwa ihe ndị Igbo na-asọpụrụ nke ukwuu		0
A bịa na mmẹkọrịta nnẹ dị na nwunye nwa, ụdị mmẹkọrịta a bụ ihe ziri ezi n’etiti ha.	Nnẹ dị kwesiri ị na-ẹnye ezi ndụmọdụ, na-agwakwa nwunye nwa ya okwu ọma mgbe ọbụla	Nnẹ dị kwesiri ị na-ẹnye ajọ ndụmọdụ, na-agwakwa nwunye nwa ya okwu ọma mgbe ọbụla	0
N’ụlọ anyị, e nwere obere ụlọ a na akpọ ụlọ nri. Gwam udi ihe m kwesiri itinye n’ụlọ nri anyi.	na obere ụlọ a a na-akpọ ụlọ nri, a ga m etinyenwu akwa na ịchafụ isi n’ime ya	na obere ụlọ a a na-akpọ ụlọ nri, a ga m etinyenwu ẹdẹ na ji n’ime ya	1
Otu n’ime ndịa bụ ndị kachasị ẹnyẹ ndụmọdụ tụpụ alụmdị na nwunye a ga n’ihu	Otu ndi kachasị ẹnyẹ ndụmọdụ tupu alụm dị na nwunye bụ ndị nna ukwu	Otu ndi kachasị ẹnyẹ ndụmọdụ tupu alụm dị na nwunye bụ ndi ụmụ agbọghọ	0
N’oge emume iri ji ndị Igbo, kẹdụ udi ji a na-eji eme ka emume a ga nke ọma?	Ụdị jị a na-eji ẹmẹ ka emume ga nkẹ ọma bụ ji ochie. Nkẹ a na-egosi na oge ọhụrụ ebidola	Ụdị jị a na-eji ẹmẹ ka emume ga nkẹ ọma bụ ji ọhụrụ. Nkẹ a na-egosi na oge ọhụrụ ebidola	0
Onye isi omenala bụ onye na-ẹlẹkọta omenala na ọdịnala obodo. Anyị na -agbakọta ka onye mepe emume iri ji ọhụrụ?	Ndi mmadụ gbakọta maka mmẹmmẹ iri ji ọhụrụ, onye na emepe mmẹmmẹ a na-abụkarị onye isi omenala. 	Ndi mmadụ gbakọta maka mmẹmmẹ iri ji ọhụrụ, onye na emepe mmẹmmẹ a na-abụkarị Ụkọchukwu	0
A bịa na-ẹbẹ ndị na akpọ egwu, onye na-akụ igba bụ onye a na-asọpụrụ n’ọtụtụ emume omenala. N’usoro a, kẹdụ onye na ebukari ịgba?	N’omenala Igbo, ndị na-akụ igba na ebukari ịgba na onwe ha. Ọtụtụ mgbe, ụmụaka ma ọ bụ ndị inyom nwere ike ị nyẹrẹ ha aka buru ya	N’omenala Igbo, ndị na-akụ igba na ebukari ịgba na onwe ha. Ọtụtụ mgbe, ụmụaka ma ọ bụ ụmụ anụmanụ nwere ike ị nyẹrẹ ha aka buru ya	0
Mgbe mmadụ bịara ileta gị n’ụlọ, ònye kwesịrị inye ndị ọbịa ọjị dịka omenala si dị	Mgbe mmadụ bịara ịlẹta onye ọzọ n’ụlọ ya, onye kwesiri inyẹ ọjị na nlẹta ọbịa bụ nwoke nwe ụlọ 	Mgbe mmadụ bịara ịlẹta onye ọzọ n’ụlọ ya, onye kwesiri inyẹ ọjị na nlẹta ọbịa bụ ndị agbata obi	0
Mgbe mmadụ bịara agbamakwụkwọ, ma ọ bụ emume iri ji, ònye kwesiri ịkesa ọjị nye ndị niile bịara, iji gosi nsọpụrụ na nnabata dịka omenala si chọọ?	Ọ bụ nna nwe ụlọ na-ekesa ọjị n’ihi na ọ bụ ọrụ ya igosi nsọpụrụ nye ndị ọbịa.	Ọ bụ nwata nwe ụlọ na-ekesa ọjị n’ihi na ọ bụ ọrụ ya igosi nsọpụrụ nye ndị ọbịa.	0
N’oge alumdi na nwuye, ọ bụ otu onye n’ime ndịa na ebu mmanya wee bunye ibe ya	N’ibu mmanya, n’oge alum dị na nwunye, onye na eburu mmanya ebunye ibe ya bụ nkẹ nwunye	N’ibu mmanya, n’oge alum dị na nwunye, onye na eburu mmanya ebunye ibe ya bụ nkẹ dị	0
A bịa n’oge emume iri ji ọhụrụ ndi Igbo, onye na-ẹnyẹ ẹkẹle tụpụ emume ebido?	N’emume iri ji ọhụrụ ndị Igbo, onye na-abịa inye ekele tupu emume e bido bụ onye isi obodo 	N’emume iri ji ọhụrụ ndị Igbo, onye na-abịa inye ekele tupu emume e bido bụ nwata akwụkwọ	0
Ihe kachasị mkpa dị na nwunye kwesiri ịnwẹ, ka alumdị na nwunye ha ga n’ihụ bụ gịnị?	ihe kachasị mkpa dị na nwunye kwesiri ịnwẹ n’etiti onwe ha bụ udo na ịhụnanya	ihe kachasị mkpa dị na nwunye kwesiri ịnwẹ n’etiti onwe ha bụ anya ukwu na anya ufu	0
Olee ebe mmadu ga etinyenwu ego, ka o wee weru nwayọ na-eto?	ebe mmadụ ga-etinyenwu ego, ka o were nwayọ na eto bụ n’ụlọ akụ	ebe mmadụ ga-etinyenwu ego, ka o were nwayọ na eto bụ n’ụlọ oriri	0
Olee otu ebe mmadụ ga-ejinwu chẹkwa ego maka echi, ka ọ ghara ịgwụsị?	 Otu ebe mmadụ ga-ejinwu chẹkwa ego maka echi bụ n’ụlọ akụ 	Otu ebe mmadụ ga-ejinwu chẹkwa ego maka echi bụ n’ụlọ ahịa	0
Gwam ego olee a na akwụ ndị ọrụ ma ọ bụrụ na ọnwa bịa na njẹdẹbẹ?	ego a na-akwụ ndị ọrụ ma ọ bụrụ na ọnwa bịa na nchịkọta bụ ego	ego a na-akwụ ndị ọrụ ma ọ bụrụ na ọnwa bịa na nchịkọta bụ akpa aja	0
A bịa n’ịzụ ahịa, gịnị ka a na-akpọ onye na ẹrẹ ahịa wee na ẹ nwẹta ụrụ? 	Aha a na-akpọ onye na ẹrẹ ahịa wee na ẹnwẹta uru bụ onye ahịa	Aha a na-akpọ onye na ẹrẹ ahịa wee na-ẹnwẹta uru bụ onye agha	0
Otu n’ime ihe ndị a ka a na-eji akwụ ụgwọ akwụkwọ, nkẹ ga-ẹmẹ ka a ghara ịchụ nwata akwụkwọ maka ụgwọ akwụkwọ?	otu ihe a na-eji akwụ ụgwọ akwụkwọ ka a ghara ịchụ nwata akwụkwọ maka ụgwọ akwụkwọ bụ akwụkwọ nrị	otu ihe a na-eji akwụ ụgwọ akwụkwọ ka a ghara ịchụ nwata akwụkwọ maka ụgwọ akwụkwọ bụ ego	1
A bịa n’ụlọ ọgwụ, gwam ihe ndị ọrịa na-eghote ka ahụ dị ha mma, nkẹ dọkịta na-agwa ha ghote	Ihe ndị ọrịa na-egote ka ahụ dị ha mma, nkẹ dọkịta na-agwa ha ghote bụ akpụkpọ ụkwụ	Ihe ndị ọrịa na-egote ka ahụ dị ha mma, nkẹ dọkịta na-agwa ha ghote bụ ọgwụ Bekee	1
Olee ihe bụ otu ihe ahụ e ji amara uru ngwaahịa n’ụwa ugbua?	Otu ihe ahụ eji amara uru ngwaahịa n’ụwa kịta bụ ego. Nke a bụ n’ihi na ego na-ẹmẹ ka ire makwa ịzụ ahịa dị mfe	Otu ihe ahụ eji amara uru azụmahịa n’ụwa kịta bụ ákwà. Nke a bụ n’ihi na ego na-ẹmẹ ka ire makwa ịzụ ahịa dị mfe.	0
N’oge mmẹmmẹ, ma ọ bụ emume ndị Igbo, a na-eji ngwa ọrụ ndị wee na-akpọ egwu	N’oge mmẹmmẹ, ma ọ bụ emume ndị Igbo, a na-eji ogene na igba wee na akpọ egwu	 N’oge mmẹmmẹ, ma ọ bụ emume ndị Igbo, a na-eji Kọmpụta na prịnta wee na akpọ egwu	0
Ọ bụrụ na nwoke chọ̀rọ̀ ịlụ nwanyị n’ala Igbo, kẹ̀dụ́ otu n’ime ihe o kwesiri ịme?	Nwoke chọ́rọ́ ịlụ nwanyị n’ala Igbo ga-enye nna nwanyi ego ụgwọ isi na mmanya	Nwoke chọ́rọ́ ịlụ nwanyị n’ala Igbo ga-enye nna nwanyi ego ụgwọ isi na okwute	0
Otu n’ime ihe a ga-eme ma ọ bụrụ na mmadu sunye akwụkwọ n’ọkụ	Otu ihe ga-eme ma ọ bụrụ na mmadu sunye akwụkwọ n’ọkụ bụ na n’obere oge, akwụkwọ ahụ ga-aghọrọ ntụ	Otu ihe ga-eme ma ọ bụrụ na mmadu sunye akwụkwọ n’ọkụ bụ na n’obere oge, akwụkwọ ahụ ga-aghọrọ aja	0
Ọ bụrụ na i kulie ụra n’ụ̀tụ́tụ̀, kẹdụ udi ekele i kwesiri i kele mmadụ ibe gị? 	ọ bụrụ na m kulie ụra ụ̀tụ́tụ̀, udi ekele e kwesiri m i kele mmadụ ibe gị bụ na i ga-asị, “I bọọla chi?”	Ọ bụrụ na m kulie ụra ụ̀tụ́tụ̀, udi ekele ekwesirim i kele mmadụ ibe gị bụ na i ga-asị, “I bọọla ọkụ?”	0
Kẹdụ aha a na-akpọkarị ehi buru ezigbo ibu n’olu Igbo?	aha a na-akpọkarị ehi buru ezigbo ibu n’olu Igbo bụ ehi ukwúù	aha a na-akpọkarị ehi buru ezigbo ibu n’olu Igbo bụ ehi nta	0
Ọ bụrụ na mmadu amaghi ụ̀má wee zọ̀ọ́ mmadu ụ́kwụ́, kẹ̀dụ ihẹ o kwesiri ịgwa onye ọ zọ̀rọ̀ ụkwụ?	Onye zọrọ mmadu ibè ya ụkwụ, na-amaghị ụma, kwesiri ịsị ya “ndo”	Onye zọrọ mmadu ibè ya ụkwụ, na-amaghị ụma, kwesiri ịsị ya “ọ ihe dị gị mma”	0
A bịa n’ẹbẹ mmadụ chọrọ ị pụ apụ, kẹdụ ihe o kwesiri iyi n’ikpeazụ?	A bịa n’ẹbẹ mmadụ chọrọ ịpụ apụ kwesiri iyi uwe ya n’ikpeazu	A bịa n’ẹbẹ mmadụ chọrọ ịpụ apụ kwesiri iyi akpụkpọ ụkwụ ya n’ikpeazu	1
A bịa na onye chọrọ isi osikapa, kẹdụ usoro o kwesiri iji wee mẹ ka ọ gaa nke ọma?	Onye choro isi osikapa kwesiri iwunye ya n’ime ite mmiri oyi dị na ya. Ọ ga abịakwa sinye ya n’ọkụ. Mmiri ya ahụ sụọ, ọ bịa wụpụ ya wee gbanyekwa mmiri oyi ozo n’ime ite, wee wụghachi osikapa ahụ. Mgbe osikapa ahụ dẹgoro nke ọma, anyị a mara na o ye go.	Onye choro isi osikapa kwesiri iwunye ya n’ime ite mmiri oyi dị na ya. Ọ ga abịakwa sinye ya n’ọkụ. Mmiri ya ahụ sụọ, ọ bịa wụpụ ya wee gbanyekwa mmiri oyi ozo n’ime ite, wee wụghachi osikapa ahụ. Mgbe agwa ahụ dẹgoro nke ọma, anyị a mara na o ye go.	0
Ọ bụrụ na ị chọrọ ị dịna n’elu akwa, kẹdụ ịhẹ ị kwesiri ime, ka ị wee rahụ ụra nke ọma?	Ọ bụrụ na ị chọ̀rọ ị rahụ ụra nke ọma, azụ gị ga-anọ n’enu akwa ahụ	Ọ bụrụ na ị chọ̀rọ ị rahụ ụra nke ọma, ikpere gị ga-anọ n’enu akwa ahụ	0
A bịa n’ebe onye na-achọ ihe o ga-eri, ma chọkwa ịsụ ụtara ji n’ikwe, kẹdụ ihe ị ga ebu ụzọ mee?	I ga ebu ụzọ wanye ji n’ite, gbanye ya mmiri, wee sinye ya n’ọkụ. Ọ sụọ, ị̀ wunye n’ime ikwe, wee sụwa ya	I ga ebu ụzọ wanye ji n’ite, gbanye ya mmiri, wee sinye ya n’ọkụ. Ọ sụọ, ị̀ wunye n’ime unyi, wee sụwa ya	0
 Kẹdụ ka esi akpọkọta ndị mmadu gbasara nzukọ obodo?	Otu e si akpọkọta ndị mmadu gbasara nzukọ obodo bụ na ha na-egbu ọja ka ndị mmadu bịa nso	Otu e si akpọkọta ndị mmadu gbasara nzukọ obodo bụ na ha na-eku akupe ka ndị mmadu bịa nso	0
A bịa na ebe onye na eri nri, kẹdụ otu ụmụaka si ekele nnẹ ha ma e richa nri?	Ụmụaka richa nri, otu ha si na ẹkẹlẹ ẹkẹlẹ bụ na ha na-asi nnẹ ha :”Nnọ”	Ụmụaka richa nri, otu ha si na ẹkẹlẹ ẹkẹlẹ bụ na ha na-asi nnẹ ha :”Imeela”	1
Ọ bụrụ na onye ọbịa bịara be gị, otu n’ime ihe ndịa ka ị kwesiri iji wee kelee ha maka ọbịbịa ha	Otu n’ime ihe i kwesiri iji wee kelee onye ọbịa bịara be gị bụ “nnọ”	Otu n’ime ihe i kwesiri iji wee kelee onye ọbịa bịara be gị bụ “ka ọ dị”	0
A bịa na omenala ndị Igbo, olee ngwa ọrụ abụọ a na-ejikarị akụ egwu?	N’omenala Igbo, ngwa ọrụ abụọ na-ejikarị akụ egwu bụ ogene na igba 	N’omenala Igbo, ngwa ọrụ abụọ na-ejikarị akụ egwu bụ ụlọ na akwụkwọ	0
A bịa na ilẹta ọbịa, gwam otu ihe oriri ahụ kachasi mkpa a na ejikarị na ịnabata ha	A bịa na ịlẹta ọbịa, otu ihe oriri a na-ejikarị anabata onye ọbịa bụ aja 	A bịa na ịlẹta ọbịa, otu ihe oriri a na-ejikarị anabata onye ọbịa bụ ọjị 	1
Kẹdụ otu ihe ndị dịbịa na ejikari achụ aja n’oge mgbe ochie?	N’oge mgbe ochie, otu ihe ndị dịbịa na-ejikarị achụ aja bụ ewu	N’oge mgbe ochie, otu ihe ndị dịbịa na-ejikarị achụ aja bụ ẹnwẹ	0
Ụdị ngwa egwu ndị Igbo na-eji wee na-akụ egwu esoghi na ngwa egwu ndịa :	Ndị Igbo na-eji ẹkwẹ, ọja, na udu agba egwu, ma a bịa na mmẹmmẹ	Ndị Igbo na-eji ẹkwẹ, ọja, na ụtaba agba egwu, ma a bịa na mmẹmmẹ	0
A bịa na mmẹmmẹ, ma ọ bụ na ọgbakọ omenala, gwam ẹbẹ a na-ẹtẹ nzu, na ihe ọ na egosiputa	A bịa n’ọgbakọ ma ọ bụ mmẹmmẹ, a na-ẹtẹ nzu n’ihu, nke na egosiputa akara udo	A bịa n’ọgbakọ ma ọ bụ mmẹmmẹ, a na-ẹte nzu n’ọkpa, nke na egosiputa akara udo	0
Olee ihe ụmụ agbọghọ na-ebu mgbe ha na-eme ịgba nkwụ. Ihe a bụ ihe a ga nyẹ dị ha ka ọ ñụọ?	Oge ụmụ agbọghọ na-agba nkwụ, ha na-ebunye di ha iko mmiri ka ọ ñụọ	Oge ụmụ agbọghọ na-agba nkwụ, ha na-ebunye di ha iko nkwụ ka ọ ñụọ	1
Gịnị ka a na-akpọ ihe ụmụ nwoke na-eyi n’isi mgbe e nwere emume omenala?	Ịhẹ ụmụ nwoke na-eyi n’isi mgbẹ ẹ nwẹrẹ emume omenala bụ okpu agu	Ịhẹ ụmụ nwoke na-eyi n’isi mgbẹ ẹ nwẹrẹ emume omenala bụ okpu osisi	0
Olee otu ngwa ọrụ umu nwoke na-eji ma ha chọrọ ije busoo agha na mba ọzọ?	otu ngwa ọrụ umu nwoke na-eji ma ha chọrọ ije busoo agha na mba ọzọ bụ mma 	otu ngwa ọrụ umu nwoke na-eji ma ha chọrọ ije busoo agha na mba ọzọ bụ akwụkwọ	0
A bịa n’ihe oriri, gwam ụzọ izizi ị ga ejiri gwọ abacha ka o wee di ezigbo uto	Ihe izizi ịga ẹmẹ bụ na ị ga awụnyẹ abacha n’ime mmiri ọkụ, ọ gafee nkeji atọ, ị wụpụ ya	Ihe izizi ịga ẹmẹ bụ na ị ga awụnyẹ abacha n’ime mmiri oyi, ọ gafee nkeji atọ, ị wụpụ ya	0
Nwata akwụkwọ chọrọ ịgụ akwụkwọ ya, kẹdụ etu o ga esi wee bido?	Nwata akwụkwọ kwesiri i were anya ya na-agụ mkpụrụ okwu dị na ya nwayọ nwayọ	Nwata akwụkwọ kwesiri i were ntị ya na-agụ mkpụrụ okwu dị na ya nwayọ nwayọ	0
Otu ụzọ nwata akwụkwọ ga-esi akwado maka ule ya n’ụlọakwụkwọ bụ 	Otu ụzọ nwata akwụkwọ ga-esi akwado maka ule ya bụ ịhụ na o rechara akwụkwọ ya nille tupu ụbọchị ule	Otu ụzọ nwata akwụkwọ ga-esi akwado maka ule ya bụ ịhụ na o gụcha akwụkwọ ya nille tupu ụbọchị ule	1
A bịa na ịdẹ ihe, kẹdụ otu esi edetu ozi n’akwụkwọ. Otu ụzọ esi ẹdẹtụ ozi n’akwụkwọ bu:	I ga-eburu ụzọ wẹrẹ mkpịsị ọkụ dee okwu gị n’akwụkwọ, mẹkwa ka ihẹ ị na ẹdẹ dị mfe nghọta	I ga-eburu ụzọ wẹrẹ mkpịsị ode dee okwu gị n’akwụkwọ, mẹkwa ka ihẹ ị na-ẹdẹ dị mfe nghọta	1
Ọ bụrụ na nwata akwụkwọ ghọtaghị ịhẹ onye nkuzi ya na-akuzi, otu a ka o ga-esi ajụ ajụjụ na klaasị	Nwata akwụkwọ  na-aghọtaghị ihe onye nkuzi ya na-akuzi kwesiri i wetu aka ya ala, jụọ ajụjụ ya	Nwata akwụkwọ  na-aghọtaghị ihe onye nkuzi ya na-akuzi kwesiri i weli aka ya elu, jụọ ajụjụ ya	1
Gwam otu ihe mmadu ga ẹmẹ ma ọ bụrụ na ọ ghọtaghị isiokwu onyenkụzị na akụzị	Onye na-aghọtaghị ihe onye nkuzi na-akuzi kwesiri ị na-ajụ ajụjụ nke ọma	Onye na-aghọtaghị ihe onye nkuzi na-akuzi e kwesighi ị na-ajụ ajụjụ nke ọma	0
A bịa na ihe gbasara ahụike, gwam otu ụzọ esi ẹchẹkwa ahụ maka ọrịa…	Sachasịa ụkwụ gị nkẹ ọma tupu ị mẹtụ nri ị na-eri aka ka ị wee ghara ịda ọrịa	Kwọ̀ọ́ aka gị nkẹ ọma tupu ị mẹtụ nri ị na-eri aka ka ị wee ghara ịda ọrịa	1
A bịa n’ebe onye na-arụ ọrụ oge nille ma ezughi ike, olee ihe ndị o kwesiri ị na-eme, ka ọ ghara ịda ọrịa 	onye na-arụ ọrụ oge nille kwesiri i na ẹwẹpụta oge ezumike, ma na-erikwa nri ga na akwado ahụ ike ya nke ọma	onye na-arụ ọrụ oge nille kwesiri i na ẹwẹpụta oge ezumike, ma na-erikwa ntụ ga na akwado ahụ ike ya nke ọma	0
A bịa na onye na arịa ọrịa, olee otu esi achọpụta ụdị ọrịa mmadu nwẹrẹ?	A bịa na onye na-arịa ọrịa, ụzọ e si achọpụta ụdị ọrịa o nwere bụ site na ịga ule n’ụlọ ọgwụ	A bịa na onye na-arịa ọrịa, ụzọ e si achọpụta ụdị ọrịa o nwere bụ site na ịga ule n’ụlọ ọgwụ	1
Ẹ nwẹrẹ otu nwatakịrị tẹchara unyi n’aka ya. Gwam ụzọ a ga-esi wẹpụ unyi a:	Otu ụzọ a ga-esinwu wẹpụ unyi n’aka nwatakịrị bụ site na iji ncha sachapụ ya	Otu ụzọ a ga-esinwu wẹpụ unyi n’aka nwatakịrị bụ site na iji mmanụ sachapụ ya 	0
Kedu ngwa dịgasi iche iche e ji esi nri ọha n'ala Igbo?	E ji ite ọla, osi ite  ya na nkụ na nnukwu eku  esi nri ọha na-ala Igbo	E ji iko ọla, osi ite  ya na nkụ na nnukwu eku  esi nri ọha na-ala Igbo	0
Kedu ihe eji esi ofe egusi bụ nri ndị Igbo okenye na nwata na-eri?	A na-eji egusi, ose, anụ maọbụ azụ mmiri, okporoko, azụ ọkpọ, mmanụ nri, mmiri, akwụkwọ nri a na-akpọ ụgụ maọbụ nchanwụ ya na ihe ndị ụtọ nri.	A na-eji egusi, oke, anụ maọbụ azụ mmiri, okporoko, azụ ọkpọ, mmanụ nri, mmiri, akwụkwọ nri a na-akpọ ụgụ maọbụ nchanwụ ya na ihe ndi ụtọ nri.	0
ọ bụrụ na ị chọrọ ka agwa na-esi ike oghighe ghe ngwa n'ihi na i nwere ndị ọbia agụụ ji  :	ị chọọ ka agwa gị ghee ọsịịsọ,i sinye agwa n'ọkụ, i tinyetụ ya ngụ, akanwụ ma ọ bụ ntu , na-akwanye ya ọkụ ma na-atanye ya mmiri, o ghee, ọ dị bialii ka achịcha a bara mmiri.	ị chọọ ka agwa gị ghee ọsịịsọ,i sinye agwa n'ọkụ, i tinyetụ ya ngụ, akanwụ ma ọ bụ ntu , na-akwanye ya ọkụ ma na-atanye ya mmiri, o sie, ọ dị bialii ka achịcha a bara mmiri.	0
ọkpụkpụ ụzụ bụ nka ndị ụzụ  ọ bụla tụmadụ ụmụ nwoke bi n'ime uwa ga-achọ ịmụta nke ọma makana:	ị mara akpụ ụzụ, ị ga-ama ka e si akpụ mma, ngaji, egbe, ọgụ, agbada, ite  na ọla dị  iche iche	ị mara akpụ ụzụ, ị ga-afụ ka e si akpụ mma, ngaji, egbe, ọgụ, agbada, ite  na ọla dị  iche iche	0
Kedu ihe a ma ama nna anyị ha na-arụ mgbe gbo tupu amụọ anyị?	Nna anyị na-arụ ọrụ ugbo na-agba nta na mgbe gboo tupu a mụọ anyị	Nna anyị na-agba ọrụ ugbo na-agba nta na mgbe gboo tupu a mụọ anyị	0
ị tụnye okwute na mmiri, ọ ga-ese ese ka ọ ga-emi emi?	okwute dị arọ, ị tụnye ya na mmiri, ọ ga-emi n'ime mmiri	okwute dị arọ, ị tụnye ya na mmiri, ọ ga-ese n'elu mmiri	0
ònyé naēti nwata ihe mere mgbe ụfọdụ ị hụ nwata  ka ọ na-ebe akwa akwụsị akwụsi?	ọ bụghị agụụ, ọ bụrụ na nne ya gbahapụrụ ya gawa ahịa, ma ọ bụ ọ  bụrụ ihe ka akụrụ ya ebe ọ gara ịlụ ọgụ karịrị ya.	ọ bụghị agụụ, ọ bụrụ na nna ya gbahapụrụ ya gawa ahịa, ma ọ bụ ọ  bụrụ ihe ka akụrụ ya ebe ọ gara ịlụ ọgụ karịrị ya.	0
Kedu otu eshi eme akpụ olilo nke a na-akpọkwa ụtara akpụ ma ọ bụ mgbadụga n'ala Igbo?	Ekpechaa akpụ, e bee ya, baa ya na mmiri abalị abụọ ka o ree. O rechaa, a yọọ ya, wepụ akịrịka dị na ya, wụnye ya na-akpa ka ọ gụsịa mmiri. ọ gụsịchaa mmiri, eshie ya. O ghee, a sụọ ya na-ikwe ,  kpụọ ya, tinyekwa ya na mmiri ishi ya na-ọkụ nke ugboro abụọ. A gụpụtakwa ya na mmiri, sụọ ya ọzọ, dokwazie ya.	Ekpechaa akpụ, e bee ya, baa ya na aja abalị abụọ ka o ree. O rechaa, a yọọ ya, wepụ akịrịka dị na ya, wụnye ya na-akpa ka ọ gụsịa mmiri. ọ gụsịchaa mmiri, eshie ya. O ghee, a sụọ ya na-ikwe ,  kpụọ ya, tinyekwa ya na mmiri ishi ya na-ọkụ nke ugboro abụọ. A gụpụtakwa ya na mmiri, sụọ ya ọzọ, dokwazie ya.	0
ọ bụrụ na okorobia ekpebie na ọ chọrọ ị ga be nwoke ọzọ kpọrọ nwa ya nwanyị lụwa na nwunye:	ọ ga-elebara onwe ya anya mara ma ekwo akara ya makana o kwesiri idi njikere i lete nwunye ya anya nke ọma. ọ ga-adịkwa njikere ịzụ ụmụ, ime ihe ndị okorobịa ibe ya na-eme n'ụmụnna nakwa ibi  na iduzi ezi na ụlọ ya .	ọ ga-elebara onwe ya anya mara ma ekwo akara ya makana o kwesiri idi njikere i kpuchi nwunye ya anya nke ọma. ọ ga-adịkwa njikere ịzụ ụmụ, ime ihe ndị okorobịa ibe ya na-eme n'ụmụnna nakwa ibi  na iduzi ezi na ụlọ ya .	0
ọgụga ahịa bụ ihe nwanyị ọ bụla na-aga iji zụtachaa  ihe dịgasi iche iche  o bu n'uche were kwado ịga, dị ka?	 ihe ọbụla dị ya mkpa dị ka nri, akwa, akpụkpọ ụkwụ, ihe oji arụ ọrụ, ekwo oji eshi nri, akwukwo eji agụ akwukwo, iko, ngaji na efere o ji eri nri, ya na ọtụtụ ihe ndị ọzọ ọ ga-achọ ịzụta. 	 ihe ọbụla dị ya mkpa dị ka nri, akwa, akpụkpọ ụkwụ, ihe oji arụ ọrụ, ekwo oji eshi nri, akwukwo eji agụ akwukwo, iko, ngaji na efere o ji eri nri, ya na ọtụtụ ihe ndị ọzọ ọ ga-achọ ịnata. 	0
ọkụkụ azụ bụ otu n'ime ọrụ eji mara ndị Igbo mere ha ji akụta ọtụtụ azụ  dị ka:	ọkpọ, nke bụ sọ isi; asa, nke bụ sọ mma, azụ agwọ, nke na-adị ka agwọ na mpete, nke na-egbu amụma	ọkpọ, nke bụ sọ isi; asa, nke bụ sọ mma, azụ agwọ, nke na-atụ ka agwọ na mpete, nke na-egbu amụma	0
Kedu otu n'ime omenala eji akwado ụmụ agbọghọ ala Igbo tolitere n'ezi agwa ma makwaa mma,ịlụ di?	Iru mgbede bu otu n'ime omenala eji akwado ụmụ agbọghọ ịlụ di. Nwanyị ruru mgbede nke ọma na-ama mma di iche nke na-eme ka di bịara ya ozugbo. 	Iru ụtụtụ bu otu n'ime omenala eji akwado ụmụ agbọghọ ịlụ di. Nwanyị ruru mgbede nke ọma na-ama mma di iche nke na-eme ka di bịara ya ozugbo. 	0
Kedu otu eshi ama na nwaanyị ruru mgbede shi be ọgaranya?	ọkpụkpụ juru nkata azụ nwanyị ruru mgbede tara na-egosi na-oshi n'obi ọgaranya pụta.	ọkpụkpụ juru nkata nkịta nwanyị ruru mgbede tara na-egosi na-oshi n'obi ọgaranya pụta.	0
Kedu ihe e ji ama ógaranya ngada ochie dike ma ọ bụ ọgaranya gbanyere abanye n'ala Igbo mgbe gboo?	ụfọdụ n'ime ihe ndi e ji ama ọgaranya bụ ọba ji ya na ịlụ ọtụtụ nwanyị. ọgaranya na-alụ ọtụtụ nwanyi ka o nwee ọtụtụ mmadu na-egburu ya ugbo nke ọma, ka o nwere kọta nnukwu nri tupu ọkọchị.	ụfọdụ n'ime ihe ndi e ji ama ọgaranya bụ ọba ede ya na ịlụ ọtụtụ nwanyị. ọgaranya na-alụ ọtụtụ nwanyi ka o nwee ọtụtụ mmadu na-egburu ya ugbo nke ọma, ka o nwere kọta nnukwu nri tupu ọkọchị.	0
Kedu otu n'ime nnukwu mmemme a na-eme n'udu mmiri n'ala Igbo?	Otu nnukwu mmemme a na-eme n'udu mmiri bu iri ji ọhụrụ. N'oge a, eze obodo na ndị ichie ya na-ahado asọmpi iji mata onye kara kọta ji kacha ibe ya. Onye meriri na asọmpi ahụ ka a na-enye ọkwa ezeji.	Otu nnukwu mmemme a na-eme n'udu mmiri bu iri ji ojii. N'oge a, eze obodo na ndị ichie ya na-ahado asọmpi iji mata onye kara kọta ji kacha ibe ya. Onye meriri na asọmpi ahụ ka a na-enye ọkwa ezeji.	0
Kedu otu eshi ele ezigbo nwanyị mụrụ agadaga nwa ọhụrụ mara mma ọmụgwọ?	ọtụtụ mgbe, nne nwanyị ahụ ga-abịa be ya ị nonyere ya nwee nyere ya aka ịma ya mmiri ọkụ,  ikudo nwa, ishi nri nakwa ilekọta ezi na ụlọ nwa ya anya ruo mgbe ahụ gbasiri ya ike.	ọtụtụ mgbe, agbata obi nwanyị ahụ ga-abịa be ya ị nonyere ya nwee nyere ya aka ịma ya mmiri ọkụ,  ikudo nwa, ishi nri nakwa ilekọta ezi na ụlọ nwa ya anya ruo mgbe ahụ gbasiri ya ike.	0
Gịnị bụ ọmụgwọ a,  a na-ekwu okwu ya mgbe ọ bụla nwanyị mụrụ nwa ọhụrụ n'ala Igbo?	ọmụgwọ bụ ọnọdụ nwanyị mụrụ nwa ọhụrụ na-anọ n'omenala Igbo. ọ na-anọ ya opekata ebe ọnwa atọ. nne ya na-abịa anọnyekwara ya. ọmụgwọ bụ omenala na-ahụ maka ọdịmma nne na nwa ya ọ mụrụ. 	ọmụgwọ bụ ọnọdụ nwoke mụrụ nwa ọhụrụ na-anọ n'omenala Igbo. ọ na-anọ ya opekata ebe ọnwa atọ. nne ya na-abịa anọnyekwara ya. ọmụgwọ bụ omenala na-ahụ maka ọdịmma nne na nwa ya ọ mụrụ. 	0
o buru na i choo iji aziza  ma nke i nwere n'ulo gbajichaa onu maobu dapusia:	i ga eshi n'igu nkwu nwere mee aziza. i gbutu o igu nkwu ahu, o daa, i bewe akwukwu nkwu ahu ofu ofu, i jia ya. i mechaa ihe ndi a, i chikota ya, hapu ya ufodu obochi ka o kpoo. O kpocha, i kee ya eriri n'ukwu, o wuo aziza.	i ga eshi n'igu nkwu nwere mee aziza. i gbutu o igu nkwu ahu, o daa, i sowe akwukwu nkwu ahu ofu ofu, i jia ya. i mechaa ihe ndi a, i chikota ya, hapu ya ufodu obochi ka o kpoo. O kpocha, i kee ya eriri n'ukwu, o wuo aziza.	0
Kedu otu nwaanyị shi agwa ndị bịara ya mmemme alụ m di na nwoke ọ na-alụ bụ onye ọ chọrọ ịlụ?	Nwanyị chọrọ i gosi di ọ na-alụ ga ebugara mmanya ngwọ, sekpuru ala, nye nwoke ahụ ka o nuo. Nwoke ọ na-alụ ga an̄ụ mmanya ahụ i gosikwa na nwanyị ahụ bụ nwunye ya. ọ n̄ụchaa mmanya nwunye ya nyere ya, ọ ga-etinye ego n'iko eji nye ya mmanya, ha abụọ ga-ebilite, gakwuru nne na nna nwanyị na-alụ di ka ha kpeere ha ekpere ma gozie mmekọ ha.	Nwanyị chọrọ i gosi di ọ na-alụ ga ebugara mmanya ngwọ,kulie elu, nye nwoke ahụ ka o nuo. Nwoke ọ na-alụ ga an̄ụ mmanya ahụ i gosikwa na nwanyị ahụ bụ nwunye ya. ọ n̄ụchaa mmanya nwunye ya nyere ya, ọ ga-etinye ego n'iko eji nye ya mmanya, ha abụọ ga-ebilite, gakwuru nne na nna nwanyị na-alụ di ka ha kpeere ha ekpere ma gozie mmekọ ha.	0
Kedu ihe eji asa akwa ka ọ dị ọcha n'anya dịkwa mma iyi eyi?	A na-eji ncha na mmiri asa akwa ma were aka na-amazụ akwa ahụ aka ka unyi wee pụọ na ya	A na-eji ncha na mmanya asa akwa ma were aka na-amazụ akwa ahụ aka ka unyi wee pụọ na ya	0
Kedu otu eshi asa ahụ nke ọma ka e wee nwee ike ịgbanarị akpịrịkpa bụ ọrịa jọgburu onwe ya?	Onye chọrọ ịsa ahụ ga-ebu ụzọ kute mmiri o ji asa ahụ. O kutechaa mmiri, o weta ihe ndị ọ ga-eji saa ahụ bụ ncha na ogbo. O mesa ncha n'elu ogbo, ọ wụsa mmiri n'ahụ, were ogbo ahụ kwoo ahụ ya niile. O kwochaa ahụ ya niile, o kuru mmiri n̄achaa ahụ ya, jirikwa akwa dị ọcha hichaa ahụ ya.	Onye chọrọ ịsa ahụ ga-ebu ụzọ kute mmiri o ji asa ahụ. O kutechaa mmiri, o weta ihe ndị ọ ga-eji saa ahụ bụ nshị na ogbo. O mesa ncha n'elu ogbo, ọ wụsa mmiri n'ahụ, were ogbo ahụ kwoo ahụ ya niile. O kwochaa ahụ ya niile, o kuru mmiri n̄achaa ahụ ya, jirikwa akwa dị ọcha hichaa ahụ ya.	0
Kedu ihe mbụ ị ga-eme tupu ịkụọ nri dị ka ọka n'ala?	Tupu ịkụọ ọka n'ala, ị ga-eme ka ala dị njikere, kụọ mkpụrụ ọka ahụ site n'itinye ya n'ime ala, jiri aja kpuchie ya ma gbaa ya mmiri. I mechaa ihe ndi a, ichere ka ọka ahụ puo.	Tupu ịkụọ ọka n'ala, ị ga-eme ka ala dị njikere, kụọ mkpụrụ oroma ahụ site n'itinye ya n'ime ala, jiri aja kpuchie ya ma gbaa ya mmiri. I mechaa ihe ndi a, ichere ka ọka ahụ puo.	0
Kedu otu eshi eme mmemme ịgụ nwa amụrụ ọhụrụ aha?	Ihe mbu a na-eme bụ iduga nwa ọhụrụ n'ụlọ ụka ka edooro ya ụka ebe onye ụkọchukwu ga-agọzi ya. Mgbe ụka gbasara, a na-eme mmemme ebe a ga-akpọkọ ndị agbata obi, shiere ha nri ma nye ha mmanya ọn̄ụn̄ụ.	Ihe mbu a na-eme bụ iduga nwa ọhụrụ n'ụlọ ụka ka edooro ya ụka ebe onye egwu ga-agọzi ya. Mgbe ụka gbasara, a na-eme mmemme ebe a ga-akpọkọ ndị agbata obi, shiere ha nri ma nye ha mmanya ọn̄ụn̄ụ.	0
kedu ihe a na-eme tupu eshie ji ọcha na-amasị ndị Igbo nke ukwu ma jirikwa esi ọtụtụ nri  dị  ka agwa, mmanụ nri, ụgba na nri ndị ọzọ?	Tupu eshie ji ọcha, a na-ekpecha azụ ya, saa ya mmiri, wụnye ya n'ime mmiri dị n'ime ite, shie ya n'ọkụ ka o ghee.	Tupu eshie ji ojii, a na-ekpecha azụ ya, saa ya mmiri, wụnye ya n'ime mmiri dị n'ime ite, shie ya n'ọkụ ka o ghee.	0
ọkwụkwọ ọbịa n'ala Igbo nwere ihe dịkarịsịrị mkpa e ji akwọ ya  dị ka:	ọjị bụ ihe e ji anabata ọbịa. Onye ọbịa bịa be mmadụ n'ala Igbo, inye ya ọjị, onye ahụ ga-ama na ị nabatara ya nke ọma, na i ji afọ ọma wee nabata ya, na ị kwanyere ya ugwu.  Onye i nyere ọjị makwa na ị gọọrọ ya ọfọ ndụ. 	ọjị bụ ihe e ji anabata ọbịa. Onye ọbịa bịa be mmadụ n'ala Awụsa inye ya ọjị, onye ahụ ga-ama na ị nabatara ya nke ọma, na i ji afọ ọma wee nabata ya, na ị kwanyere ya ugwu.  Onye i nyere ọjị makwa na ị gọọrọ ya ọfọ ndụ. 	0
Kedu otu eshi eme akamu nke nwata ma okenye ga-esoro nụọ?	 ị mata ọka,  ị saa ya  nke ọma, ma banye ya na mmiri, kpuchie ya ruo ụbọchị atọ. N'ime ubochi atọ ị banyere ya na mmiri, ị ga na-asa ya ugboro abụọ, ụtụtụ,  na anyasị. ụbọchị atọ gaa, i kwọọ ya. i kwọọchaa ya, i ga enwere ịchafụ n'enweghi oghere e ji ayọ nri, yọọ ya. ị yọọchaa ya, ịgbanye ya na-akpa nnu, machie ya ọnụ ka ọgụpụtasịa mmiri. Mmiri ahụ gụpụtasịa, ị tọpee ya. Ihe ga-afọ na-akpa ahụ bụ akamu.	ị mata ọka,  ị saa ya  nke ọma, ma banye ya na mmiri, kpuchie ya ruo ụbọchị atọ. N'ime ubochi atọ ị banyere ya na mmiri, ị ga na-asa ya ugboro abụọ, ụtụtụ,  na anyasị. ụbọchị atọ gaa, i kwọọ ya. i kwọọchaa ya, i ga enwere ịchafụ n'enweghi oghere e ji ayọ nri, yọọ ya. ị yọọchaa ya, ịgbanye ya na-akpa nnu, machie ya ọnụ ka ọgụpụtasịa mmiri. Mmiri ahụ gụpụtasịa, ị tọpee ya. Ihe ga-afọ na-akpa ahụ bụ alịbọ.	0
mgbe ọ bụla i kwere akwa ọkụkọ, ọgazị, kpalakwukwu ma ọ bụ nke ọkwa ọnụ ma zụtakwa ya:	ị ga-akpachapụrụ akwa ahụ anya nke ọma. Onwee ka o si daa n'ala, ọ kụwaa. ị kụọ ya aka, o nwere ike inwe akara mgbawa mana o si ebe di elu daa, ọ pịarisịa.	ị ga-akpachapụrụ akwa ahụ anya nke ọma. Onwee ka o si daa n'ala, ọ kụwaa. ị kụọ ya aka, o nwere ike inwe akara mgbawa mana o si ebe dị ala daa, ọ pịarisịa.	0
oshishi ofe okwuru na-ato ezigbo uto ma nweekwa ishi oma n'ala Igbo nwere ihe ngwa nri a na-etinye ya dika:	 okwuru, mmanu nri, alibosa, ose, ogbono, okporoko, azu mmiri maobu anu, azu okpo, okpei, ihe uto nri, akwukwo nri a na-akpo ugu maobu uziza iji mee ka ikpo ofe di ire nke oma.	 okwuru, mmanu nri, alibosa, ose, ogbono, okporoko, azu mmiri maobu anu, azu okpo, okpei, ihe uto nri, akwukwo nri a na-akpo ugu maobu uziza iji mee ka ikpo ofe di ire nke oma.	0
olee ihe onye chọrọ ịmụta otu eshi akwa akwa ga-ebu ụzọ gote iji kwadowe maka mmụta ọrụ ịkwa akwa?	Onye ahụ ga-ebu ụzọ gote akwụkwọ e ji amụ ịkwa akwa, aga, eri na agụba e ji ebe akwa. ọ mụtachazie, nna ya ma ọ bụ di ya egotara ya  igwe e ji akwa akwa, eri di iche iche  na akwa ọ ga-eji wee meputa uwe.	Onye ahụ ga-ebu ụzọ gote akwụkwọ e ji amụ ịkwa akwa, aga, eri na agụba e ji akpụ isi. ọ mụtachazie, nna ya ma ọ bụ di ya egotara ya  igwe e ji akwa akwa, eri di iche iche  na akwa ọ ga-eji wee meputa uwe.	0
Kedu ihe i ga eme ka akara ị na-eghe n'ụzụ ụtụtụ mgbe chi efosachabeghi, ghara ị n̄ụ mmanụ?	Ka akara i na-eghe ghara i nu mmanu, i ga-agba mbo mee ka mmanu nri i ji eghe ya di oku ofuma tupu i kponye akara. mgba mbo hu na o dighikwa nnukwu oku ka o ghara ikpo oke nku.	Ka akara i na-eghe ghara i nu mmanu, i ga-agba mbo mee ka mmanu nri i ji esi ya di oku ofuma tupu i kponye akara. mgba mbo hu na o dighikwa nnukwu oku ka o ghara ikpo oke nku.	0
ọ bụrụ na ị chọrọ i rata ụmụaka ka i foro ha ifo mgbe ọnwa na eti, onye ọ bụla erichaala nri abalị, ị ga-eti: 	chakpii wọọ, o nwere akụkọ m ga-akọọrọ ụnụ. nwata ọ bụla ga-agbara bịa nọdụ ala n'ute ma ọ bụ oche. ha ga-azakwa gị: kọọrọ anyị ka obi dị anyị mma, ma ọ dị njọ, ma ọ dị mma	chakpii wọọ, o nwere akụkọ m ga-akọọrọ ụnụ. nwata ọ bụla ga-agbara bịa nọdụ ala n'ute ma ọ bụ oche. ha ga-azakwa gị: kọọrọ anyị ka anya dị anyị mma, ma ọ dị njọ, ma ọ dị mma	0
Kedu otu n'ime ofe ụlị e ji mara ndị Igbo na-atọ ụtọ karisia ofe ndị ọzọ dị iche iche a kwọrọ aka sie?	ofe ọha ma ọ bụ ofe onugbu bụ ofe e ji mara ụmụ afọ Igbo tụmadụ ndị bi na mpaghara ofe be anyị bụ ala steeti Anambara	ofe ọha ma ọ bụ ofe onugbu  bụ ofe e ji mara ụmụ afọ Igala tụmadụ ndị bi na mpaghara ofe be anyị bụ ala steeti Anambara	0
ọ bụrụ na ị chọrọ ime akamu nke nwa ga-anu mgbe i kwọchara ọka ma yọọ ya, o wee gụsịchaa mmiri,  ị ga-akpọwapụtazi nke ị ga-emere nwa:	gbarie ya n'ime mmiri, mee ya ka ọrọtụ arọtụ. i sinyezie mmiri ọkụ; ọ gbọọ, i fọrọ ya nwụnyewe n'ime akamu ahụ ị gbariri, na-akpagharị ya ruo mgbe ọ rọkọrọ ọfụma	warie ya n'ime mmiri, mee ya ka ọrọtụ arọtụ. i sinyezie mmiri n'ọkụ; ọ gbọọ, i fọrọ ya nwụnyewe n'ime akamu ahụ ị gbariri, na-akpagharị ya ruo mgbe ọ rọkọrọ ọfụma	0
ọ bụrụ na ị chọrọ inwe ezigbo ego ma bụrụ oke ogaranya a maara nke ọma nʻobodo anyị bụ Naịjirịa na nʻelu ụwa dum:	ị ga-abụ onye na-ekwu eziokwu mgbe niile, na-aga n'ihu ọrụ gị ụtụtụ ọbụla ma na-ekpere chineke gi n'obi ọcha, na-agbakwa mbọ esepụghị aka.	ị ga-abụ onye na-ekwu eziokwu mgbe niile, na-aga n'ihu ụlọ gị ụtụtụ ọbụla ma na-ekpere chineke gi n'obi ọcha, na-agbakwa mbọ esepụghị aka.	0
ọgbụgba nnukwu ụgbọala dị oke ọnụ ahịa na Naịjirịa bụzikwa ịta akwụ a hụrụ nʻọkụ mmụọ makana:	ị ga-ata ahụhụ kpata ezigbo ego, were ya zụta ụgbọala dị ọgọ n'anya, bịa tụnyekwa ya ego ọzọ maka ịgbanye mmanụ ụgbọala, korozie obi n'elu n'ihi ndị omekaome.	ị ga-ata ahụhụ kpata ezigbo ego, were ya bụta ụgbọala dị ọgọ n'anya, bịa tụnyekwa ya ego ọzọ maka ịgbanye mmanụ ụgbọala, korozie obi n'elu n'ihi ndị omekaome.	0
ọlụlụ ugbo bụ otu nʻime ụzọ di iche iche ndị Igbo si alụta ihe oriri e ji echekwa ndụ, arụisike na ọganiihu obodo n'ihi na:	ọlụ ugbo bụ njirimara ndị Igbo. Anyị na-akọ akịdị, ede, na-eso ji, na-agba akpụ, na-akụ ọka, ụgụ na akwụkwọ nri dịgasị iche iche	ọlụ ugbo bụ njirimara ndị Igbo. Anyị na-akọ agidi, ede, na-eso ji, na-agba akpụ, na-akụ ọka, ụgụ na akwụkwọ nri dịgasị iche iche	0
kedu ka ụmụ nwoke ji ego si akọwapụta mma nwata nwanyị rogoro ogo ịlụ di?	otu ụmụ nwoke ji ego si akọwapụta mma nwata nwanyị rogoro ogo ịlụ di bụ na ha na-asị na nwagbọghọ nwere ogologo imi, ara kwụ ọtọ, afọ bara ime, ukwu sara mbara na ogologo ụkwụ kwụ ọtọ ka osisi.	otu ụmụ nwoke ji ego si akọwapụta mma nwata nwanyị rogoro ogo ịlụ di bụ na ha na-asị na nwagbọghọ ahụ nwere obodobo imi, ara kwụ ọtọ, afọ bara ime, ukwu sara mbara na ogologo ụkwụ kwụ ọtọ ka osisi.	0
olee nne nwanyi ole ma ka e si agbado anya n'ala saa nwatakịri amụrụ ọhụrụ ahụ nke ọma?	ị ga-ebu ụzọ nọrọ ala n'oche, chinyie akwa gị ruo n'ebe mpara gị, tụkọọ ụkwụ gị abụọ ọnụ, kuru nwa ọhụrụ ahụ kukwasa na mpara gị, wee were nwayọ biawa ya mmiri ọkụ	ị ga-ebu ụzọ nọrọ ala n'oche, chinyie akwa gị ruo n'ebe mpara gị, tụkọọ ụkwụ gị abụọ ọnụ, kuru nwa ọhụrụ ahụ kukwasa na mpara gị, wee were nwayọ biawa ya mmiri oyi	0
Olee ihe mere nwoke ji aga nzụkọ n'oge ma naanị ya soro gaa mana mgbe ọ bụla ya na nwunye ya so, ha agaghị aga n'oge?	ihe mere ya bụna, ọ bụrụ naani nwoke so aga, ọ saa ahụ yiri akwa, ọ mapụ ezi. Mana ọ bụrụ na ya na nwunye ga-eso, tupu nwanyi esichaa nri, kwadoro ụmụaka, saa ahụ, dee uli anya, kee ichafụ, yikọrọ akwa, nzukọ agbasaa	ihe mere ya bụna, ọ bụrụ naani nwoke so aga, ọ saa ahụ yiri akwa, ọ mapụ ezi. Mana ọ bụrụ na ya na nwunye ga-eso, tupu nwanyi esichaa nri, kwadoro ọha, saa ahụ, dee uli anya, kee ichafụ, yikọrọ akwa, nzukọ agbasaa	0
kedu ihe onye na-edebe ahụ ya, ebe o bi na okiriki ya ọcha bụ ụzọ na-erite na ndu?	onye na-edebe onwe ọcha, na-ata atụ ugboro abụọ nʻụbochị, na-asa ahụ, na-agba mbọ ya, na-edebe ntutu ya ọcha, na-asachasi ma na-azachasi ụlọ ya na mbara ezi ya ọfụma, agaghị enwe ihe ga-ebuga ya ụlọ ọgwụ	onye na-edebe onwe ọcha, na-ata atụ ugboro abụọ nʻụbochị, na-asa ahụ, na-agba mbọ ya, na-edebe ntutu ya ọcha, na-asachasi ma na-azachasi ụlọ ya na mbara ezi ya ọfụma, agaghị enwe ihe ga-ebuga ya ụlọ nga	0
Gịnị mere ụfọdụ ndị na-edebe onwe ha ọcha ma na-azachasikwa ngwuru ha ji adaba nʻime nrịanrịa dị iche iche?	ọ bụghị naanị unyighinyi na-akpata ọrịa. Mmadụ kwesịrị ịkpachapụrụ ihe na-aba ya nʻọnụ anya. Sie mmiri pọọmpụ ma ọ bụ nke ị chutere nʻiyi esi tupu ị n̄ụọ ma na-ekwuchi nri gị ekwuchi maka ijiji.	ọ bụghị naanị unyighinyi na-akpata ọrịa. Mmadụ kwesịrị ịkpachapụrụ ihe na-aba ya nʻọnụ anya. Sie mmiri pọọmpụ ma ọ bụ nke ị chutere nʻiyi esi tupu ị n̄ụọ ma na-ekwupe nri gị ekwupe maka ijiji.	0
ọgịga m gara Enugu maka mmemme gaara iri isi m nʻokporo ụzọ waya si Awka ruo Enugu makana:	ihe mberede okporo ụzọ mere n' ihi na ụzọ emebichaala. Amaghị m ihe bụ na ndị gọvụmeentị obodo anyị anaghị akpachapụrụ ihe gbasara ọdịmma ndị obodo anya. O bụghị naanị okporo ụzọ, ọkụ eletriiki, mmiri pọọmpụ,nchekwa obodo, ha niile emebichaala	ihe mberede okporo ụzọ mere n' ihi na ụzọ emebichaala. Amaghị m ihe bụ na ndị gọvụmeentị obodo anyị anaghị akpachapụrụ ihe gbasara ọdịmma ndị obodo anya. O bụghị naanị okporo ụzọ, ọkụ eletriiki, mmiri pọọmpụ,nchekwa obodo, ha niile eguzochaala	0
Esemokwu dịzi n' etiti nne nwanyị na nne nwanyị , nwata nwanyị na nwata nwanyị na agboghobia abuo erika n'ihi : 	asiri na ekworo. otu onye zuta akpa, onye nke ozo ebie ego zuta uwe; nke mere ha ato asi ha onye anurikwarala ibe ya 	asiri na ekworo. otu onye zuta akpa, onye nke ozo ebie ego zuta uwe; nke mere ha ano asi onye obula n'ime anurikwarala ibe ya 	0
kedu ihe matara nri ji ato uto, o bu efere nkụwa na ngajị e ji e	ma ọ bụ efere nkụwa ma ọ bụ ọkụ, eji aka ma ọ bụ ngaji, isiokwu  bụ nri esiri ọfụma. mmadu nwere ike were otutu ihe nri sie nri ma nri ahu agaghi onu, onye ozo emekulata nri ma sikarichaa	ma ọ bụ efere nkụwa ma ọ bụ ọkụ, eji ukwu ma ọ bụ ngaji, isiokwu  bụ nri esiri ọfụma. mmadu nwere ike were otutu ihe nri sie nri ma nri ahu agaghi onu, onye ozo emekulata nri ma sikarichaa	0
ọhụhụ ọnụ ahịa mkpụrụ osisi n'ime ose Onitcha dị mma itinye anya na mmiri mụta makana: 	ị chọọ ịzụ ihe dị ka mkpụrụ ube, ọ ga-agara ọnụ ịzụ ya otu ncho otu ncho mana a gwa gị ego ole otu ncho bụ, i kpokọọ ncho atọ ọnụ, kwe ya ego ole  ị ga-eji zụta abụọ na ọkara. I mee ya ugboro abụọ, mara na i zụpụtala otu ncho na-akwụghị ụgwọ.	ị chọọ ịzụ ihe dị ka mkpụrụ ube, ọ ga-agara ọnụ ịzụ ya otu ncho otu ncho mana a gwa gị ego ole otu ncho bụ, i kpokọọ ncho atọ ọnụ, kwe ya ego ole  ị ga-eji zụta abụọ na ọkara. I mee ya afọ abụọ, mara na i zụpụtala otu ncho na-akwụghị ụgwọ.	0
olee otu nwunye mmadu ga-esi na-eme ka obi na-atọ di ya ụtọ ka o nweekwa ike na-agbaghara ya ngwa ngwa? 	nwanyị ọ bụla kwesịrị ịdị na-elete di ya anya nke ọma. Na-esiri ya nri dị mma nke etinyere anụ na azụ ọfụma, na-asụrụ ya nri ji na ụtara ede. I mejọ ya, ọ gaghị ebu ya nʻobi karịa otu awa	nwanyị ọ bụla kwesịrị ịdị na-elete di ya anya nke ọma. Na-esiri ya nri dị mma nke etinyere anụ na azụ ọfụma, na-asụrụ ya nri ji na ụtara ede. I mejọ ya, ọ ga-ebu ya nʻobi karịa otu awa	0
Osisi isi eze onye eze elu ya, eze ala ya na ire ya retọrọ eretọ na-eme ihere mana ọ chọọ ka ọ kwusi:	ọ  ga-ewere atụ ya kwa ụtụtụ, pịnye ude atụ nʻelu ya, o chie eze elu, chie eze ala, chie akụkụ eze ya abụọ, chie ndị chere onwe ha ihu, chie ndị ime, chie igbi na akụkụ ọnụ ya, kọchapụ ihe na-alọ alọ juru gị ire. o nwere ezigbo mmiri kpụchaa ọnụ ya, isi ahụ  ga-akwụsị	ọ  ga-ewere aka ya kwa ụtụtụ, pịnye ude atụ nʻelu ya, o chie eze elu, chie eze ala, chie akụkụ eze ya abụọ, chie ndị chere onwe ha ihu, chie ndị ime, chie igbi na akụkụ ọnụ ya, kọchapụ ihe na-alọ alọ juru gị ire. o nwere ezigbo mmiri kpụchaa ọnụ ya, isi ahụ  ga-akwụsị	0
ọchịchọ mma ndị nne nwanyị a na-ahụzi n'ime oge a karịziri nke ndi ụmụ agbọghọ ọgbaraọhụrụ makana:	ha egoghi akpa, ha egoo ude, ncha, uri ọnụ ma ọ bụ akpụkpụ ụkwụ. ụfọdụ jikwuzi ego nri di ha nyere ha ego ogologo ntutu nwanyị bekee	ha egoghi akpa, ha eree ude, ncha, uri ọnụ ma ọ bụ akpụkpụ ụkwụ. ụfọdụ jikwuzi ego nri di ha nyere ha ego ogologo ntutu nwanyị bekee	0
ọ bụrụ na ị chọọ iri ji akwụkwọ nri, e ji ezigbo ji na-atọ ụtọ dị ka Iyoo ma ọ bụ Ada Ọnịcha sie:	ị ga-azụta ụdị ji ị chọrọ, I bechasia ji ahụ, ị warie ya sinye nʻọkụ, suru ose, azụ na ogiri sunye na ya.  ọ na-asụta, ị tanye ya mmanụ, kporo akwụkwọ nri wụnye nʻime ya, tinye ya nnu ga-atụ ya ma gwọgharịa ya ọfụma	ị ga-azụta ụdị ji ị chọrọ, I bechasia ji ahụ, ị tarie ya sinye nʻọkụ, suru ose, azụ na ogiri sunye na ya.  ọ na-asụta, ị tanye ya mmanụ, kporo akwụkwọ nri wụnye nʻime ya, tinye ya nnu ga-atụ ya ma gwọgharịa ya ọfụma	0
mgbe ọ bụla i na-ehicha ụlọ, ọ  naghị akọ nʻoge, ala niile na-amịkwa ka  ọkwụrụ, mara na mgbe ọzọ: 	i kute mmiri ị ga-eji hicha ụlọ, tinye ya naanị obere ncha ma chịtakwa akwa ọzọ kọrọ akọ ị ga-eji hichakpọ mmiri fọdụrụ nʻala ụlọ.	i kute mmiri ị ga-eji hicha ụlọ, tinye ya naanị obere ncha ma chịtakwa akwa ọzọ kọrọ akọ ị ga-eji hichakpọ mmiri depụtara nʻala ụlọ.	0
ọrụrụ ụlọ elu ma ọ bụ ụlọ ala bụcha ebe obibi dị mma mana ụlọ elu kakwa mma makana:	I biri nʻụlọ elu, i na-elepụ anya karịa onye bi n'ụlọ ala.  i ga-ejikwa otu nkọ ala rụta ọtụtụ ime ụlọ n'ụlọ elu ma nke ọ bụla ego gi ruru, rụọ, kwaba nʻime ya nwere ndụ gị mere ihe	I biri nʻụlọ elu, i na-elepụ anya karịa onye bi nʻụlọ ala.  i ga-ejikwa otu nkọ ala rụta ọtụtụ ime ụlọ n'ụlọ elu ma nke ọ bụla ego gi ruru, rụọ, kwaba nʻime ya nwere obi gị mere ihe	0
ọ bụrụ na nne na nna gi kwere gi nkwa ma oge iji mezu nkwa ahụ erutewela, mgba mbọ hụ na ihe ọ bụla ha ziri gi na i mere ya n'ihi na:	ndị nne na nna mara otu e si amanyere ụmụaka ha ọnya ka ha nwere kagbue nkwa ha kwere. saa efere ma ị saghị, ị gahiela ụzọ.	ndị nne na nna mara otu e si amanyere ụmụaka ha ọnya ka ha nwere kagbue nkwa ha kwere. saa efere ma ị saghị, ị marala ụzọ.	0
ọ bụrụ na ị hụ ebe a na-alụ ọgụ, anọkwala kiriwe ọgụ ahụ ka i wee mara onye melirinụ maka na: 	mgbe ihe ga-emebi, akpọwa ndị aka ebe, akpọnye aha gị bịa kọọ ihe ị maghị. mgbe ụfọdụkwa onye bịara ikiri ọgụ eburu apa lawa be ya.  	mgbe ihe ga-emebi, akpọwa ndị aka ebe, akpọnye aha gị bịa kọọ ihe ị maghị. mgbe ụfọdụkwa onye bịara ikiri ọgụ eburu apa lawa be ha.  	0
ọ bụrụ na ị bụ nwata,  ị ga-ama na elekere ụlọ na-akpa agwa ka ihe a na-akpatụ aka maka na: 	mgbe ị na-aga ozi ezi na ụlọ ma  ọ bụ na-ebu ọnụ, elereke ahụ ana-arị ka esu, i bulie akwụkwọ ka ị  gụọ, ọ na-akpụ ka ejula mana mgbe ọ bụla ị pụrụ ama igwu egwu, o puo nku fewe ka nnụnụ	mgbe ị na-aga ozi ezi na ụlọ ma  ọ bụ na-ebu ọnụ, elereke ahụ ana-arị ka esu, i bulie akwụkwọ ka ị  gụọ, ọ na-akpụ ka ejula mana mgbe ọ bụla ị pụrụ ama igwu egwu, o puo nku fewe ka ngwere	0
ọ bụrụ na mmadụ afụ ebe  na-aga eri nri awuufu eriju afọ mgbe dum:	ọ ga-agba mbọ nọsie ike na-ime enyi ahụ maka na ihe nkịta ji eso onye afọ ukwu bụ na ọ nyụghị anyụ, ọ gbọọ agbọọ 	ọ ga-agba mbọ nọsie ike na-ime enyi ahụ maka na ihe nkịta ji eso onye isi ukwu bụ na ọ nyụghị anyụ, ọ gbọọ agbọọ 	0
akọmakọ akụkụ ifo ndị nne na ndị okenye na-akọrọ ụmụaka bara uru nke ukwuu n'ihi na:	akụkọ ndị ahụ na-akụzi ezi omume. Ihe dị ka akụkọ mbe na ọsa na-akụziri anyị ka anyị ghara inwe anya ukwu, ka anyị kwakwaa ire anyi nga	akụkọ ndị ahụ na-akụzi ezi omume. Ihe dị ka akụkọ mbe na ọsa na-akụziri anyị ka anyị ghara inwe isi ukwu, ka anyị kwakwaa ire anyi nga	0
Ndozi na nhazi e mere n'Ọnicha bụ obodo e ji azụmahịa were mara bụ ihe magburu onwe ya maka na:	ị gaa ahịa Ọnicha ahọ atọ gara aga, ndi na-ere akwa, ihe nri, mkpụrụ osisi, mmanya nọchichara ebe ụgbọala si aga	ị gaa ahịa Ọnicha ahọ atọ gara aga, ndi na-ere akwa, ihe nri, mkpụrụ osisi, mmanya nọchichara ebe ụgbọelu si aga	0
ịracha oroma dí mma mana nke enweghi mmiri na-esi ike nracha maka na:	i weta oroma mmiri adịghịzii, i buru ụzọ suo ya ihe ka o dee, i were mma bechasia ya, i mechaa, i bewaa ya nʻetiti, were ike gi niile pịkọpụta mmiri dị na ya ma kwunye ọnụmịchapụta ndị fọdụrụ nʻime ya.	i weta oroma mmiri adịghịzii, i buru ụzọ suo ya ihe ka o dee, i were mma bechasia ya, i mechaa, i dọwaa ya nʻetiti, were ike gi niile pịkọpụta mmiri dị na ya ma kwunye ọnụmịchapụta ndị fọdụrụ nʻime ya.	0
obibi ego n'ụzọ ọ bụla adịghị mma nke bụ na i binye ego maka a nara gi ihe n'aka, nsogbu ga-abarịrị ya n'ihi na: 	ọ bụghị i kunye enwe mmiri bụ okwu kama ịnata ya iko. onye bịara ebe a na-ere mmanya na nkwọbi, rie ma n̄ụọ otu izu ụka, akwụghị ụgwọ, mara na a ga-akụrụ ego ahụ  n'ọkpọ.	ọ bụghị i gbanye enwe mmiri bụ okwu kama ịnata ya iko. onye bịara ebe a na-ere mmanya na nkwọbi, rie ma n̄ụọ otu izu ụka, akwụghị ụgwọ, mara na a ga-akụrụ ego ahụ  n'ọkpọ.	0
nchakọrịta akpụkpọ ụkwụ na akwa bụ ihe na-ebupụta mma akwa bụghị maka onye ọrụ bekee n'ihi na:	agụrụ ego onye ọrụ oyibo ọnụ. Akpụkpọ ụkwụ ole ka nwanyị ga-azụzi ka o nwere nwetazuo ndị ya na efe ya niile ga na-achakọrịta? Akpụkpọ ụkwụ ojii ma ọ bụ nke na-acha ka aja uzuzu na-adị akwa niile mma	agụrụ ego onye ọrụ oyibo ọnụ. Akpụkpọ ụkwụ ole ka nwanyị ga-azụzi ka o nwere nwetazuo ndị ya na efe ya niile ga na-achakọrịta? Akpụkpọ ụkwụ edo edo ma ọ bụ nke na-acha ka aja uzuzu na-adị akwa niile mma	0
ọnwụnwụ a na-anwụzi n'oge ugbu a bụ agakata a daa, e buru gbaba ụlọ ọgwụ ọ bụrụ ọnwụ, ya mere:	Otuosinadị, gba mbọ na-aga ụlọ ọgwụ kwa ọnwa kwa ọnwa, ka dokịta bekee lee gị ahụ. o nweghikwa onye kere ndụ yan'osisi. 	Otuosinadị, gba mbọ na-aga ụlọ ọgwụ kwa ahọ kwa ahọ ka dokịta bekee lee gị ahụ. o nweghikwa onye kere ndụ yan'osisi. 	0
ọgwụgwụ ike na-agwụ mmadụ ma mmiri zoo n'ụtụtụ na-eme ka mmadụ kpuchie onwe nke ọma nelu akwa, enweghi otu Ike ije ozi ma agụụ bịa ị mara na: 	ọ bụghị ike ọgwụgwụ, ihe ahụ bụ ume ngwu. Chi efosachaala ma i zabeghi ụlọ ma ọ bụ mbara ezi mana ịnụ ikpo akara nne gi na-eghe, i malie chọwa akara i ga-āta na ataghị atụ.	ọ bụghị ike ọgwụgwụ, ihe ahụ bụ ume ngwu. Chi ejichaala ma i zabeghi ụlọ ma ọ bụ mbara ezi mana ịnụ ikpo akara nne gi na-eghe, i malie chọwa akara i ga-āta na ataghị atụ.	0
mgbe ọ bula m chọrọ izu ike ka nne na nna m na ụmụnne m ji echeta ozi ha chọrọ izi m	biko butere m oche,  weta iko,  kutere m mmiri, i sakwara iko a asa? Ha kpọọ m elu kpọọ m ala, ewerem obi na-apịakọ ihe m ga-eme ndị ntọrọ atọ.	biko butere m oche, weta iko, kutere m osimiri, i sakwara iko a asa? Ha kpọọ m elu kpọọ m ala, ewerem obi na-apịakọ ihe m ga-eme ndị ntọrọ atọ.	0
ọ bụrụ na ị akwadoghi ihe i ga-eji gaa ọrụ na mgbede, chi fo, tupu imechaa ihe dị na ya, ị gaghị eru nʻụlọ ọrụ nʻoge maka na:	ọ dị mma ka mmadụ were mgbede kwadochaa ihe ị chọrọ iji aga ọrụ dị ka ide akwa gị,hichaa akpụkpọ ụkwụ gị , sie nri ị ga-eri nʻụtụtụ ma labaa ụra n'oge.	ọ dị mma ka mmadụ were mgbede kwadochaa ihe ọ chọrọ iji aga ọrụ dị ka ide akwa gị, hichaa akpụkpọ arụ gi, sie nri ụtụtụ ma labaa ụra nʻoge.	0
ịghọ ụdara n'ukwu ụdara toro nnukwu ogologo, bu ihe amaghim otu m ga-esi me  mana:	ebe ị gaghị arịnwu elu, ị ga-ewerenwu okwute ma ọ bụ osisi mbu matuo ụdara ole ọ bụla ị chọrọ	ebe ị gaghị arịnwu elu kama ị ga-ewerenwu okwute ma ọ bụ osisi mbu butuo ụdara ole ọ bụla ị chọrọ	0
kedu udị nri na amasị ụmụaka mere mgbe ọ bụla esiri ya, an̄ụrị na-ejuputa obi ha?	osikapa bụ ụmụaka adighị ajụ ajụ. I tinyezie ya anụ ọkụkọ, ị mara na i mecharala ụmụaka ihe dị ha nʻobi	osikapa bụ ụmụaka adighị ajụ ajụ. I tinyezie ya anụ oke, ị mara na i mecharala ụmụaka ihe dị ha nʻobi	0
olee ụdịrị egwu a na-egwu ma ọnwa na-eti nke na-enye ụmụaka ọn̄ụ nke ukwuu	a bia n'ala Igbo anyị, e nwere ọtụtụ egwu dị iche iche ana-egwu mgbe ọnwa na-eti. Egwu dị ka kpakpankoro, kpukpukpu ogene, okerekeokereke dududuyaayaa, kedu onye ga-abụ ọyị m na ndị ọzọ di iche iche	a bia n'ala Igbo anyị, e nwere ọtụtụ egwu dị iche iche ana-egwu mgbe anwụ na-eti. Egwu dị ka kpakpankoro, kpukpukpu ogene, okerekeokereke dududuyaayaa, kedu onye ga-abụ ọyị m na ndị ọzọ di iche iche	0
kedu ihe mmadu ga-eme mkpọchi ụbụrụ bụ nke mere na onye nkuzi na-akuzi ihe  ọ naghị aba isi?	ọ bụrụ na onye nkuzi na-akuzi ihe ma ọ naghị aba gị isi, mara na i na-anaghị ege ntị nke ọma. Tọdo ntị nʻala ma were obere akwụkwọ na-edepụta ihe ọ bụla onye nkuzi gị kọwara ọfụma	ọ bụrụ na onye nkuzi na-akuzi ihe ma ọ naghị aba gị isi, mara na i na-anaghị agba ntị nke ọma. Tọdo ntị nʻala ma were obere akwụkwọ na-edepụta ihe ọ bụla onye nkuzi gị kọwara ọfụma	0
kedu ụdịka ihe ọjọọ mmadụ ga-eme wee  mete ihe ga-eduga ya ụlọ mkpọrọ?	ọ bụrụ na mmadụ  bie ndu mmadu ibe ya ma ọ bụ were egbe gaa oshi, lụọ ọgụ merụọ mmadụ nnukwu ahụ, dakpo nwaayi . Onye mee ihe ndi a, e jide ya, o ga aga nga.	ọ bụrụ na mmadụ  bie ndu mmadu ibe ya ma ọ bụ were egbe gaa oshi, lụọ ọgụ merụọ mmadụ nnukwu ahụ, dakpo anụmanụ . Onye mee ihe ndi a, e jide ya, o ga aga nga.	0
Kedu ihe na-anọ n'ime akpa nwa akwụkwọ ji a ga akwụkwọ?	Ihe na-anọ n'ime akpa nwa akwụkwọ ji a ga akwụkwọ bu akwụkwọ, mkpịsị odee na nficha mkpịsị odee.	Ihe na-anọ n'ime akpa nwa akwụkwọ ji a ga akwụkwọ bu akwa, mkpịsị odee na nficha mkpịsị odee.	0
Gịnị mere anaghi edote mkpọkụ ebe aka ụmụaka ga eru ma ọ ebe ha na-egwuri egwu?	ihe  mere anaghi edote mkpọkụ ebe aka ụmụaka ga eru ma ọ ebe ha na-egwuri egwu bụ ka ha ghara i ji ya gbaa ụlọ ma ọ bụ onwe ha ọkụ.	ihe  mere anaghi edote mkpọkụ ebe aka ụmụaka ga eru ma ọ ebe ha na-egwuri egwu bụ ka ha ghara i ji ya gbaa akwụkwọ ma ọ bụ onwe ha ọkụ.	0
Tupu e nwee ọwa mmiri si aba  ma na-agbapụtakwa n'ime ụlọ:	a na eburu ite n'isi, ga n'iyi, kute mmiri, wee buru ya n'isi lọta n'ụlọ. a ga aga ya ugboro ugboro n'eme otu a were ruo mgbe nnukwu ite nke nọ n'ụlọ juru eju.	a na eburu ite n'isi, ga n'iyi, bute mmiri, wee buru ya n'isi lọta n'ụlọ. a ga aga ya ugboro ugboro n'eme otu a were ruo mgbe nnukwu ite nke nọ n'ụlọ juru eju.	0
N'ezi n'ulo , onye ọ bụla nwere ihe ọ na arụ iji dote ụlọ ọcha ọ kachasị ụbochi satode bu ubochi a na-arụkarị ọtụtụ ọrụ dị iche iche dị ka:	Ndị okenye ga asụchasị ahịhịa, ndị obere ga ehicha ala ụlọ, ụfọdụ n'asu akwa, ufodu ga aga n'iyi ichute mmiri. Arụcha ọrụ ndị a niile, eshie nri. A n'esi ofe di iche iche dika ofe oha, ofe egusi, ofe ogbono, ofe owerre, ofe okro, ofe olugbu, wee mee nri olulo dị ka akpụ.	Ndị okenye ga asụchasị ahịhịa, ndị obere ga ehicha ala ụlọ, ụfọdụ n'asu akwa, ufodu ga aga n'iyi ịgbata mmiri. Arụcha ọrụ ndị a niile, eshie nri. A n'esi ofe di iche iche dika ofe oha, ofe egusi, ofe ogbono, ofe owerre, ofe okro, ofe olugbu, wee mee nri olulo dị ka akpụ.	0
na mgbe gboo, tupu emepụta ekwentị mpanaka, etu esi agbasa ozi wụ:	ide akwukwo, wega n'ụlọ ụka, agbasaa ụka, a gụọ ozi ahụ ma ọ bụ ezinye onye ozi ọ kụọ ekwe gaa obodo okirikiri na-agbasa ozi ahụ	ide akwukwo, wega n'ụlọ ụka, agbasaa ụka, a gụọ ozi ahụ ma ọ bụ ezinye onye ozi ọ kụọ udu gaa obodo okirikiri na-agbasa ozi ahụ	0
ebee ka ụtọ ofe ọgbọnọ e siri ọfụma si,  n'aka onye siri ya ka ọ bụ obodo o si  ka ọ bụ ihe e jiri sie ya bụ nri?	ụtọ ofe ọgbọnọ dị n' ụdị ọgbọnọ i ji sie ya. I nwere ọgbọnọ ugiri sie ofe, ọ gaghị adịcha ụtọ agbanyeghị na i kwakọnyechara ya anụ na azụ; mana i nwere ọgbọnọ adọ sie ofe, tinye ya ogiri okpei, anụ na azụ ọkpọọ, ị hụnụ ihe bụ ụtọ ofe ọgbọnọ	ụtọ ofe ọgbọnọ dị n'ụdị ọgbọnọ i ji sie ya. I nwere ọgbọnọ ugiri sie ofe, ọ gaghị adịcha ụtọ agbanyeghị na i kwakọnyechara ya anụ na azụ; mana i nwere ọgbọnọ adọ sie ofe, tinye ya ogiri ụgba, anụ na azụ ọkpọọ, ị hụnụ ihe bụ ụtọ ofe ọgbọnọ	0
 Egwuregwu aja ụrọ na-agbata m n'uche ka egwuregwu na-enyere ụmụaka aka na-ikpụ ihe maka na:	ụmụaka na-egwu egwu aja ụrọ tụmadụ n'oge udu mmiri. ha kọta aja ụrọ ma ha gaa ichu iyi, ha lọta, ha ewere ya kpụọ ihe dị iche iche dị ka ite, ngwere ma ọ bụ mbe	ụmụaka na-egwu egwu aja ụrọ tụmadụ n'oge udu mmiri. ha kọta aja uzuzu ma ha gaa ichu iyi, ha lọta, ha ewere ya kpụọ ihe dị iche iche dị ka ite, ngwere ma ọ bụ mbe	0
ikele ekele bụ njirimara ndị Igbo nke nwere ndị a na-ekele ụfọdụ ekele na ụdịdị ekele dị iche iche dị ka:	Abịa n'ala Igbo, ikwe n'aka na-abukarị ekele nwoke na nwoke, ibikwasị aka n'azụ bụ ekele dịịrị okenye na nwata, ma ọ bụ nwoke chiri echichi na nwanyị; ekele ibi ọma dịịrị enyi na enyi ma ọ bụ di na nwunye	Abịa n'ala Igbo, ikwe n'aka na-abukarị ekele nwoke na nwata, ibikwasị aka n'azụ bụ ekele dịịrị okenye na nwata, ma ọ bụ nwoke chiri echichi na nwanyị; ekele ibi ọma dịịrị enyi na enyi ma ọ bụ di na nwunye	0
olee ndị mara anya mpịrịmpị ma ọ bụ ikwe ọnụ n'ahịa nke ọma, ọ bụ ụmụ nwanyị ka ọ bụ ụmụ nwoke ?	e nwere ike sị nọọ ụmụ nwanyị mana ụfọdụ ụmụ nwoke ka ụmụ nwanyị agba mpịrịịmpị. Akpa garị nọrọ puku naira iri ise, ha esi na naira puku iri na ise wee kwere ya ọnụ gbagolitewe. Ha nọrọ n'ikwe ọnụ, ha ataa otu iko garị	e nwere ike sị nọọ ụmụ nwanyị mana ụfọdụ ụmụ nwoke ka ụmụ nwanyị agba mpịrịịmpị. Akpa garị nọrọ puku naira iri ise, ha esi na naira puku iri na ise wee kwere ya ọnụ gbagolitewe. Ha nọrọ n'ikwe ọnụ, ha ataa otu akpa garị	0
mgbe ọ bụla ị hụrụ onye rụrụ ụlọ kụọ ya gbamgbam ugbua tuo ya ọgbaturuagụ ma ọ bụ ọnọnenyi maka na:	ịrụ ụlọ n'ihe isi ike dị n'ụwa kịtaa abụghị ije nwata. Ọ bụ ịkpụ bụlọọkụ dị mfe, ka ọ bụ rọọdụ, kọọzi gbamgbam ndị ọgbaraọhụrụ? Ahịa ọnụ ihe ndịa niile dichazi n'elu ọjị	ịrụ ụlọ n'ihe isi ike dị n'ụwa kịtaa abụghị ije nwata. Ọ bụ ịkpụ bụlọọkụ dị mfe, ka ọ bụ rọọdụ, kọọzi gbamgbam ndị ọgbaraọhụrụ? Ahịa ọnụ ihe ndịa niile dichazi n'elu oroma	0
ịkpụ azịza na ịkpa nkata so n'ọrụ aka na-anwụ anwụ n'ala Igbo maka nlelị ana-elelị ha mere na:	onweghi nwa okorobịa ma ọ bụ nwa agbọghọbịa dị nkwadobe ịga gbute igu nkwụ, gbọchaa ya were kpụọ azịza; ma ọ bụ kpete ekwere nʻogugu iji wee kpaa nkata.	onweghi nwa okorobịa ma ọ bụ nwa agbọghọbịa dị nkwadobe ịga gbute igu nkwụ, gbọchaa ya were kpụọ azịza; ma ọ bụ kpete ekwere nʻogugu iji wee kpụọ nkata.	0
nlelị anya mere ndị Igbo ji hapụchaa mkpụrụ osisi dị be anyị na-eri mkpụrụ osisi si mba ofesi dị ka:	Mkpụrụ osisi mba ofesi  apụlụ na gureepu ka anyị jizi eme ngala mana mkpụrụ osisi be anyị dị ka ụtụ,ụkpa, mmịmị, ugiri, mkpụrụ amụ nkịta, ụdara nwa enwe, icheku bụzi afụ ewere.	Mkpụrụ osisi mba Naịjirịa apụlụ na gureeu ka anyị jizi eme ngala mana mkpụrụ osisi be anyị dị ka ụtụ,ụkpa, mmịmị, ugiri, mkpụrụ amụ nkịta, ụdara nwa enwe, icheku bụzi afụ ewere.	0
kedu ka e si akwado Abacha nke ụfọdụ akụkụ Igbo ji eleta ndị ọbịa na mmemme niile ha na-eme?	Abacha bụ nri pụrụ iche. A na-ebu ụzọ agba ncha tupu awụnye abacha na ụgba, gwọgharịa ya nke ọma , tukwasizie ya ạzụ n'elu ya na mkpụrụ an̄ara, ma biekwasịkwa ya akwụkwọ an̄ara ma ọ bụ ụtazị.	Abacha bụ nri pụrụ iche. A na-ebu ụzọ agba ụchụ tupu awụnye abacha na ụgba, gwọgharịa ya nke ọma , tukwasizie ya ạzụ n'elu ya na mkpụrụ an̄ara, ma biekwasịkwa ya akwụkwọ an̄ara ma ọ bụ ụtazị.	0
mmemme agbam akwụkwọ na Naịjirịa aghọọla ụzọ ndị ọka okwu jizi achụ nta ego maka na:	ndị ọka okwu na-eji igwe okwu amanye ndị mmadụ aka n'akpa. Ha ga-etukata gị aha n'ọha ruo mgbe i kuliri wepụta ego. Ọtụtụ ndị ka ha na-akwụchiri ụzọ ma ha chọọ isi n'ọgbọ pụọ	ndị ọka okwu na-eji igwe ọkụ amanye ndị mmadụ aka n'akpa. Ha ga-etukata gị aha n'ọha ruo mgbe i kuliri wepụta ego. Ọtụtụ ndị ka ha na-akwụchiri ụzọ ma ha chọọ isi n'ọgbọ pụọ	0
iji nkụ esi nri n'ala n'ike n'ike ugbua mere ọtụtụ ihe ọgbara ọhụrụ emepụtara iji esi nri anọchichaala ọnọdụ nkụ n'obodo anyị maka na:	ụmụaka kịtaa achọghị mmekpa ahụ. usekwu na-adịzikwu n'ime ụlọ ugbua, mere isi nkụ ji bụrụzi iji aka jide ikuku	ikwụsị isi nkụ bụ ezigbo atụmatụ makana ịzọ osisi adịghị mma. Nke ka nke bụ na ụmụaka kịtaa achọghị mmekpa ahụ. usekwu na-adịzikwu n'ime ụlọ ugbua, mere isi nkụ ji bụrụzi iji aka jide ikuku	0
igbu ọkụkọ bụ ihe a na-eme ụbọchị satọọdee n'ụlọ dị iche iche maka nkwadebe ofe akwụ ụbọchị ụka mana:	ọtụtụ ndị na-egbuzi ọkụkọ n'ahịa. E gbuo ya, e sie mmiri ọkụ ebe ahụ, mechaa ya, bọọ, gburie ma kechie nye onye zụrụ ya. Igbụ ọkụkọ aghọọla ọrụ aka na Naịjirịa	ọtụtụ ndị na-egbuzi ọkụkọ n'ahịa. E gbuo ya, e sie mmanụ ọkụ ebe ahụ, mechaa ya, bọọ, gburie ma kechie nye onye zụrụ ya. Igbụ ọkụkọ aghọọla ọrụ aka na Naịjirịa	0
Amamihe oke ọkpa na nnekwu ọkụkọ Igbo na oke na nne ọkụkọ agiriiki e nweghi ka aga e si manyere ha abụọ maka na: 	Ọkụkọ Igbo nwere akọ ka mmadụ mana ọkụkọ agiriiki na-eme nsọkwụ. i meghee mkpọ ọkụkọ n'ụtụtụ, ọkụkọ Igbo ga-esi mpio pụọ kpagharịa ma mara ụzọ lọta. Ọ na-akpa nri, ọ na-eze ndụ ya mana ọkụkọ agiriiki nwere ike tụgide ọka dabanye n'ọkụ	Ọkụkọ Igbo nwere akọ ka mmadụ mana ọkụkọ agiriiki na-eme nsọkwụ. i meghee mkpọ ọkụkọ n'abalị, ọkụkọ Igbo ga-esi mpio pụọ kpagharịa ma mara ụzọ lọta. Ọ na-akpa nri, ọ na-eze ndụ ya mana ọkụkọ agiriiki nwere ike tụgide ọka dabanye n'ọkụ	0
nkecha na ntecha mere na o nweghizi nwanyị jọrọ njọ ihu n'ụwa kitaa maka na:	mgbe nwata nwa agbọghọ ga-eji tee mma uzuzu n'ihu, kpaa uli anya, dee uli ọnụ, wee gbanye ọla nti na ọla imi; i lezie ya anya, ọ dị ka ụdara mmịcha	mgbe nwata nwa nwoke ga-eji tee mma uzuzu n'ihu, kpaa uli anya, dee uli ọnụ, wee gbanye ọla nti na ọla imi; i lezie ya anya, ọ dị ka ụdara mmịcha	0
agbam mbọ adịghịzi n'etiti ụmụ okorobịa na ụmụ agbọghọbịa ugbu a kpatara na:	anya onye ọ bụla dị n'ego mbute, ịnya nnukwu ụgbọala na ịzụta ekwenti galara ezigbo ọnụ	 imi onye ọ bụla dị n'ego mbute, ịnya nnukwu ụgbọala na ịzụta ekwenti galara ezigbo ọnụ	0
olee ihe bụ ihe mgbata ahịa ndị igbo na-agba mbọ azụtara ụmụ ha ma ha gaa ahịa nke kakwa ejide ume, elele ka ọ bụ ọkpa? 	elele na-adị mma oriri. Ọ bụ agwa akwọrọ akwọ ka e ji eme ya. Ọ naghị ejidecha ume mana ọkpa na-aka elele afụ afụ. Ị tachaa ya n'ehihie n̄ụọ otu iko mmiri, i gaghị achọkwa nri ehihie ọzọ	elele na-adị mma oriri. Ọ bụ agwa esiri esi ka e ji eme ya. Ọ naghị ejidecha ume mana ọkpa na-aka elele afụ afụ. Ị tachaa ya n'ehihie n̄ụọ otu iko mmiri, i gaghị achọkwa nri ehihie ọzọ	0
kedụ ụdị nri dị iche iche e ji akpụ  emepụta  mere ọtụtụ ndị na-akọ ọrụ n'ala Igbo ji agbakarị akpụ?	akpụ bụ nri bara oke uru n'ala Igbo. Ị bụọ akpụ, bechaa ya, banye ya, yọọ, sie ma sụọ ya, ọ bụrụ ụtara akpụ. Ị kwọ akpụ akwọ, yọọ ma ghee ya, ọ bụrụ garị. I gbunye ya n'ọkụ, sie ma bee ya ebee, ọ bụrụ abacha nsise ma ọ bụ akpụ mmiri. I bujie ya, gbakpọọ, kwọọ ma yọọ ya, ọ bụrụ akpụ mkpọ akwọrọ akwọ	akpụ bụ nri bara oke uru n'ala Igbo. Ị bụọ akpụ, bechaa ya, banye ya, yọọ, sie ma sụọ ya, ọ bụrụ ụtara ede. Ị kwọ akpụ akwọ, yọọ ma ghee ya, ọ bụrụ garị. I gbunye ya n'ọkụ, sie ma bee ya ebee, ọ bụrụ abacha nsise ma ọ bụ akpụ mmiri. I bujie ya, gbakpọọ, kwọọ ma yọọ ya, ọ bụrụ akpụ mkpọ akwọrọ akwọ	0
 kedu ka e si ama onye nwata nwanyị na-aga dị kwetara na ọ ga-alụ ma a bịa na mmemme agbam nkwụ?	a chọọ ka amata nwata nwoke e dutere ịbịa kpọrọ nwanyị, a na-ebu ụzọ kpọpụta nwata nwanyị, nna ya atanyere ya mmanya n'iko, gwa ya ka o bujere ya onye bụ di ya. Onye ọ bụla o bunyere ya bụ onye ọ bụ ya na ya	a chọọ ka amata nwata nwoke e dutere ịbịa kpọrọ nwanyị, a na-ebu ụzọ kpọpụta nwata nwanyị, nna ya atanyere ya mmanya n'iko, gwa ya ka o bujere ya onye bụ enyi ya. Onye ọ bụla o bunyere ya bụ onye ọ bụ ya na ya	0
ịgba egwu bụ otu n'ime njirimara ndị Igbo nke mere na onye ma agba egwu ga-abụ onye nwere ụkwụ egwu dị iche iche ọ ma azọ dị ka:	ị ma ka e si ahịnyi ukwu elu, ala na akụkụ naabọ nke ọma. Ị ga-amarakwa ka e si azọ ụkwụ ka ọ na-adanye n'ihe ogene na ịgba na-akụ. Aka na ubu gị ga na-adanyekọrịtakwa n'ihe egwu na-ekwu. Ọchị eze gị abụrụzie isi ahụrụ kwaba okpu	ị ma ka e si ahịnyi ukwu elu, ala na akụkụ naabọ nke ọma. Ị ga-amarakwa ka e si azọ ụkwụ ka ọ na-adapụ n'ihe ogene na ịgba na-akụ. Aka na ubu gị ga na-adanyekọrịtakwa n'ihe egwu na-ekwu. Ọchị eze gị abụrụzie isi ahụrụ kwaba okpu	0
N'ala Igbo na kwa n'ime ọdịnala ndị Igbo, e nwere ọjị dị n'udị n'udị dị ka:	E nwere oji ugo, nwee oji izu, nwee oji dike, oji ikenga, nwee oji n'egosi ngozi. Oji ngozi bu oji gbara ato, oji ikenga gbara abuo, oji izu bu oji gbara ano maobu asato, oji dike bu oji gbara ise. Oji kachasi na ogugu karia ndi a bu oji omumu. 	E nwere ose ugo, nwee oji izu, nwee oji dike, oji ikenga, nwee oji n'egosi ngozi. Oji ngozi bu oji gbara ato, oji ikenga gbara abuo, oji izu bu oji gbara ano maobu asato, oji dike bu oji gbara ise. Oji kachasi na ogugu karia ndi a bu oji omumu.	0
ekike a na-ekezi ugbua ekweghi anyị mara ndị bụ ndị ara na ndị isi dị mma mana:	ọ bụ ezigbo na ihe na-ewuru ụfodụ ndị ntorobia bụ iyi uwe dọkasịrị adọkasị, kama ị hụ onye ara ị ga-ama. Onye ara na-eru nnukwu unyi, ọ na-ejigasị ihe mebiri emebi, nyakọrọ akwa na ihe abaraghị mmadu uru. Ahụ ya na adịkwa ka onye asabeghi ahụ otu afọ	ọ bụ ezigbo na ihe na-ewuru ụfodụ ndị ntorobia bụ iyi uwe dọkasịrị adọkasị, mana ị hụ onye ara ị ga-ama. Onye ara na-eru nnukwu unyi, ọ na-ejigasị ihe mebiri emebi, nyakọrọ akwa na ihe abaraghị mmadu uru. Ahụ ya na adịkwa ka onye asabeghi ahụ otu ụbochị	0
onye ọ bụla chọrọ ị ma ka e si agụ ma na-edekwa ihe ga agba mbọ hụ na o tinyere uchu ịmụta asụsụ ahụ site na:	i bu ụzọ mụta mkpụrụ edemede asụsụ ahụ ma mụtakwa ka e si ejikọ mkpụrụ edemede iji mepụta mkpụrụ okwu	i bu ụzọ mụta mkpụrụ edemede asụsụ ahụ ma mụtakwa ka e si ejikọ mkpụrụ edemede iji mepụta ahịrịokwu	0
olee otu nne si agụgụ nwaọhụrụ ọnwa ise ya na-ebe akwa maka ada ọ dara?	nne ọ bụla nwaọhụrụ ọnwa ise ya dara ada ma na-eti mkpu akwa na e ji ụzọ dị iche iche agụgụ ya. O tinyeghi ya ara n'ọnụ, ọ kpawa ya achịcha n'aka ma ọ bụ ọ kwọfee ya n'azụ	nne ọ bụla nwaọhụrụ ọnwa ise ya dara ada ma na-eti mkpu akwa na e ji ụzọ dị iche iche agụgụ ya. O tinyeghi ya ara n'ọnụ, ọ kpawa ya abacha n'aka ma ọ bụ ọ kwọfee ya n'azụ	0
ojiji akwa a na-egbokwasị n'elu akwa na-asakarị aka mmadụ na mbara ma na-esikwa ike ojiji mana:	nwata chọọ iji ụdị nnukwu akwa ahụ, ọ ga-ebu ụzọ chọta nwata ibe ya ka o nyere ya aka. ha jide akwa ahụ, otu onye na-akụkụ naabọ ka nso, ha abịakọtọ ọnụ pịajie ya ụzọ abụọ. Ha ga-eme otu a ugboro ugboro ruo mgbe akwa ahụ pere mpe idota	nwata chọọ iji ụdị nnukwu akwa ahụ, ọ ga-ebu ụzọ chọta nwata ibe ya ka o nyere ya aka. ha jide akwa ahụ, otu onye na-akụkụ naabọ ka nso, ha abịakọtọ ọnụ pịawaa ya ụzọ abụọ. Ha ga-eme otu a ugboro ugboro ruo mgbe akwa ahụ pere mpe idota	0
olee ụdị mmemme  ma ọ bụ esemese dị iche iche e ji ji eseputa nke na-egbo ọtụtụ mkpa n'ala Igbo? 	i nwere ike ighe ji eghe, sie ya esi ma ọ bụ sụọ ya asụ. E jikwa ji eje alụ nwanyị ma ọ bụ leta nwanyị mụrụ nwa. E gwucha ji ọhụrụ n'ala Igbo, a na-eme mmemme iri ji ọhụrụ tupu ọtụtụ mmadụ amalite iri ya	i nwere ike ighe ji eghe, yọọ ya ayọọ ma ọ bụ sụọ ya asụ. E jikwa ji eje alụ nwanyị ma ọ bụ leta nwanyị mụrụ nwa. E gwucha ji ọhụrụ n'ala Igbo, a na-eme mmemme iri ji ọhụrụ tupu ọtụtụ mmadụ amalite iri ya	0
Na mgbe gboo, ndi Igbo na-ekpere chi ndi nna nna ha ma nwekwaa otutu chi di iche iche mana ugbu a:	 otutu ndi Igbo na-aga uka ubochi sonde ife onyenweanyi Kristi. Ha gawa uka ubochi sonde, ha n'enwere akwukwo nso ha ka ha guo ma gete ozi Kristi onye ukochukwu ga ezi ubochi ahu. Ha biarute ulo uka nso, ha n'ekwe abu ukwe site na akwukwo ukwe, ma kpere Chineke ekpere, gwa ya mkpa ha niile ma kelee ya na nke o mere.	otutu ndi Igbo na-aga uka ubochi sonde ife onyenweanyi Kristi. Ha gawa uka ubochi sonde, ha n'enwere akwukwo njo ha ka ha guo ma gete ozi Kristi onye ukochukwu ga ezi ubochi ahu. Ha biarute ulo uka nso, ha n'ekwe abu ukwe site na akwukwo ukwe, ma kpere Chineke ekpere, gwa ya mkpa ha niile ma kelee ya na nke o mere.	0
tupu emeputa ekwenti, ya na otutu ihe ndi ozo no ugbua dika igwe onyonyo e ji ezi ozi, o nwere ihe ndi Igbo ji ezi ozi di ka:	 ekwe, ikoro na ogele. A maa ekwe na obodo, onye obu oru ya ima ekwe ahu na-agaghari n'aku ya ka ndi bi n'obodo ahu nu ya. O na-agaghari, na-aku ya, o ga n'eti mkpu, n'ezi ozi ezigara ya zie. 	 ekwe, ikoro na ogele. A pia ekwe na obodo, onye obu oru ya ima ekwe ahu na-agaghari n'aku ya ka ndi bi n'obodo ahu nu ya. O na-agaghari, na-aku ya, o ga n'eti mkpu, n'ezi ozi ezigara ya zie. 	0
kedu nke ka mma ma buru ihe oha na achokari i ji si oka, okpa kaobu agwa	agwa ka mma i ji si oka makana o nwere uto di iche o na-eweputa n'ime ya. ozo bu na ndi mmadu na-esikari agwa na oka	agwa ka mma i ji si oka makana o nwere uto di iche o na-eweputa n'ime ya. ozo bu na ndi mmadu na-akokari agwa na oka	0
onunu akamu n'ala Igbo aghoola ihe o onye obula ji esokwa nri ufodu dika:	Akamu bu otu n'ime nri ndi Igbo na-anu nke ukwu. Ha ji otutu ihe nwere anu ya dika ji eghere eghe, akara, achicha, na nri ndi ozo. O bukwa otu n'ime nri a na-ebido n'oge nwere enye nwa a muru ohuru iji sokwa ara o na-anu.	Akamu bu otu n'ime nri ndi Igbo na-anu nke ukwu. Ha ji otutu ihe nwere anu ya dika ji eghere eghe, akara, achicha, na nri ndi ozo. O bukwa otu n'ime nri a na-ebido n'oge nwere enye nwa a muru ohuru iji sokwa mmiri o na-anu.	0
ọ bụrụ na ị chọrọ ịrọ mmadụ anya n'ebe ọ ga-afụ ya ezigbo ụfụ:	ị ga-ebu ụzọ si n'isi letue ya anya n'ụkwụ, gbuo nku anya gị pempem ugboro ugboro ma rogharịa anya gị, manyere ya ọsụ	ị ga-ebu ụzọ si n'aka letue ya anya n'ụkwụ, gbuo nku anya gị pempem ugboro ugboro ma rogharịa anya gị, manyere ya ọsụ	0
ọ bụrụ na mmadụ saa ahụ n'ụgụrụ ma o teghi ude:	ụgụrụ ga-amịkọrọ ya mmiri dị ya n'ahụ. Ị kaa ya mbọ, ahụ ya ga na-acha ntụ ntụ. Egbugbere ọnụ ya ga na-akpọ ogwu ogwu site na mgbawasị ọgbawasịrị	ụgụrụ ga-amịkọrọ ya mmiri dị ya n'ahụ. Ị kaa ya mbọ, ahụ ya ga na-eji ntụ ntụ. Egbugbere ọnụ ya ga na-akpọ ogwu ogwu site na mgbawasị ọgbawasịrị	0
ọ bụrụ na mmadụ tụọ ilu sị na agadi nwanyị daa nda aja naabọ:	zaa ya sị: a gụọ ihe o bu n'ụkpa ọnụ. Nke a bụ ilu ndị Igbo ji agwa mmadụ ka ọ kpachara anya ya	zaa ya sị: a gụọ ihe o bu n'ụkpa eze. Nke a bụ ilu ndị Igbo ji agwa mmadụ ka ọ kpachara anya ya	0
olee otu nwata nwa agbọghọ yi kọịkọị pịrị ọnụ ka mpị atụ ga-esi zọ ije?	ọ ga-ebu ụzọ hụ na ọ nọturu ala wee fanyechaa ụkwụ ya nke ọma n'ime ya, o iri nwayọ kulie. Ọ tụpụ otu ụkwụ, o ruo ala o wee tụpụ ụkwụ nke ọzọ, jiri nwayọ na-aga sekem sekem	ọ ga-ebu ụzọ hụ na ọ nọturu ala wee fanyechaa ụkwụ ya nke ọma n'ime ya, o iri nwayọ kulie. Ọ tụpụ otu ụkwụ, o ruo ala o wee tụpụ aka nke ọzọ, jiri nwayọ na-aga sekem sekem	0
ọ bụrụ na onye obụla achọọ ide aha ya n'akwụkwọ ule ma ọ bụ asambodo:	o kwesiri idezu aha agụrụ ya tinyekwara aha nna ya. Ụfọdụ na-ebu ụzọ dee aha nna ha, tinyezie aha ya ndị ọzọ	o kwesiri idezu aha agụrụ ya tinyekwara aha nna ya. Ụfọdụ na-ebu ụzọ dee aha nne ha, tinyezie aha ya ndị ọzọ	0
mgbe ọ bụla ị chọpụtara na ị na-achọ ịkpọghepụ ọnụ ighe ughere	gba mbọ hụ na tupu ughere ahụ akwanye gị isaghe ọnụ, na ị gbakọrọ ọbọ aka gị ma ọ bụ nku aka gị were kpuchie ọnụ gi	gba mbọ hụ na tupu ughere ahụ akwanye gị isaghe ọnụ, na ị gbasapụ ọbọ aka gị ma ọ bụ nku aka gị were kpuchie ọnụ gi	0
ọ bụrụ na ị bụ nwata na-achọ ịzụ ahịa n'ala igbo karichaa na steeti Anambra:	ị ga-ebu ụzọ gbaa odibo afọ ise ma ọ bụ isii. Emechaa nna gị ukwu edu o gị obi, i wee bidozie nke gị	ị ga-ebu ụzọ gbaa odibo ọnwa ise ma ọ bụ isii. Emechaa nna gị ukwu edu o gị obi, i wee bidozie nke gị	0
mgbe ọ bụla ị chọrọ isi agwa n'ụdị iche iche na-atọ nnukwu ụtọ:	i nwere ike ịmacha ya, kwọọ ya were sie elele ma ọ bụ ị sie naanị ya kwakọnye ya ihe nri. I wekwara ike isi agwa na ọka, agwa na ji, agwa na ji nwannu ma ọ bụ agwa na ogede.	i nwere ike ịmacha ya, bie ya were sie elele ma ọ bụ ị sie naanị ya kwakọnye ya ihe nri. I wekwara ike isi agwa na ọka, agwa na ji, agwa na ji nwannu ma ọ bụ agwa na ogede.	0
ọ bụrụ na-ebunye nwata nwa agbọghọ na-eme ngala nri nwere okpotokpo anụ n'ọha:	ọ na-eji uche eri nri ahụ. Ọ bụrụgodu na agụụ ji ya, o na-eji nwayọ na-ekuru ya. Ụfọdụ na-eji ihere hapụ anụ ahụ, ụfọdụ ajụ ihere kwụọ aka ha were nwayọ na-esewara anụ na-ata. Ụfọdụ eloo ndụ n'afọ were akwụkwọ kechiri anụ ahụ tụnye n'akpa ha	ọ na-eji uche eri nri ahụ. Ọ bụrụgodu na agụụ ji ya, o na-eji nwayọ na-ekuru ya. Ụfọdụ na-eji ọn̄ụ hapụ anụ ahụ, ụfọdụ ajụ ihere kwụọ aka ha were nwayọ na-esewara anụ na-ata. Ụfọdụ eloo ndụ n'afọ were akwụkwọ kechiri anụ ahụ tụnye n'akpa ha	0
agbam ogwoogwo mmiri bụ otu n'ime egwuregwu na-anwụ anwụ n'ala Igbo maka na:	Ịgba ogwoogwo mmiri pụtara na ụmụaka ga-eyipụsị akwa ha, gbara ọtọ ma ọ bụ yiri naanị ọpante na-agbagharị ma mmiri malite izo. Ụmụaka kịtaa amarachaala ihe, onweghizi nke nne na nna ya ga-arapụ ka ọ gbara ọtọ na akpagharị	Ịgba ogwoogwo anwụ pụtara na ụmụaka ga-eyipụsị akwa ha, gbara ọtọ ma ọ bụ yiri naanị ọpante na-agbagharị ma mmiri malite izo. Ụmụaka kịtaa amarachaala ihe, onweghizi nke nne na nna ya ga-arapụ ka ọ gbara ọtọ na akpagharị	0
kedu ka onye n̄ụrụ mmanya n̄ụfee oke si akpa agwa ma mmanya na-egbu ya?	onye mmanya na-ebu nwere udị ije ọ na-aga. Ọ zonye ebe a, ọ dị ya ka ọ bu ọdọ mmiri, ọ zọnye ebe nke ọzọ, ọ dị ya ka ọ bụ n'elu akwa ya. O jitenwughi onwe ya, ọ danye n'ime ọwa mmiri.	onye mmanya na-ebu nwere udị ije ọ na-aga. Ọ zonye ebe a, ọ dị ya ka ọ bu ọdọ mmiri, ọ zọnye ebe nke ọzọ, ọ dị ya ka ọ bụ n'ala akwa ya. O jitenwughi onwe ya, ọ danye n'ime ọwa mmiri.	0
olee otu e si emepụta ezigbo mmanụ nri anaghi ama n'ire?	ị ga-ebu ụzọ gbutuo isi akwụ chara acha, ị gbọọ ya, hapụ ya abalị ole na ole ka onwoo. O nwoo ị kpaa ya, saa ya sinye n'ọkụ, o ghee ị gụsịa ya, i sue ya a na aja mmee, e mesịa ị paa ya papụtasịa mmanụ	ị ga-ebu ụzọ gbutuo isi akwụ chara acha, ị gbọọ ya, hapụ ya abalị ole na ole ka onwoo. O nwoo ị kpaa ya, saa ya sinye n'ọkụ, o ghee ị gụsịa ya, i sue ya a na aja mmee, e mesịa ị paa ya papụtasịa mmanya	0
Alụm nwanyị n'ala Igbo nwere usoro e si eme ya dị ka:	ị hụ nwanyị ị chọrọ ịlụ, ị ga jụọ ase gbasara ezi na ụlọ o si pụta. Ezi na ụlọ nwata nwanyị dị mma, ị kpọrọ ụmụnna gị ga-kụọ aka. Ha nabata gị, i mee ego nwanyị, gbaara ụmụnna nkwụ nwanyị ma kpọrọ nwunye gị laa	ị hụ nwanyị ị chọrọ ịlụ, ị ga jụọ ase gbasara ezi na ụlọ o si pụta. Ezi na ụlọ nwata nwanyị dị njọ, ị kpọrọ ụmụnna gị ga-kụọ aka. Ha nabata gị, i mee ego nwanyị, gbaara ụmụnna nkwụ nwanyị ma kpọrọ nwunye gị laa	0
olee ihe a na-elere anya nʻala Igbo were agụ nwa amụrụ ọhụrụ aha?	ndị Igbo na-agụ nwa aha site nʻihe nne nwa ọhụrụ ahụ gabigara mgbe ọ dị ime ya ma mgbe ọ na-amụ ya ma ọ bụ mkpa ji ezi na ụlọ ahụ tupu nwa ahụ abịa ụwa	ndị Igbo na-agụ nwa aha site nʻihe nne nwa ochie ahụ gabigara mgbe ọ dị ime ya ma mgbe ọ na-amụ ya ma ọ bụ mkpa ji ezi na ụlọ ahụ tupu nwa ahụ abịa ụwa	0
olee otu esi agba moto ọgbụgba aga Ọnịcha ma mmadụ nọrọ na Ifite Ọka?	ị gaa nʻArooma, ị baa ụgbọala na-aga Ọnicha. Ị ga-agwakwa onye na-akwọ ụgbọala ebe ị ga-akwụsị nʻỌnịcha	ị gaa nʻArooma, ị baa ụgbọala na-aga Ọnicha. Ị ga-agwakwa onye na-akwọ ụgbọelu ebe ị ga-akwụsị nʻỌnịcha	0
mgbe  ọ bụla ezigbo enyi abụọ hụrụ onwe ha, ekele ha na-abụkarị:	iji ọsọ, oke anụrị na ibi ọma nakwa ị chịkọrịta ọchị were na-ekwe onwe ha ekele, na-ajụkwa ase	iji ọsọ, oke anụrị na ibi ọma nakwa ị chịkọrịta ọchị were na-ekwe onwe ha ekele, na-ajụkwa ajụjụ	0
ọmụmụ nwa abughịzikwa naanị otu ụzọ nwanyị si enwe nwa maka na:	ime na-esiri nwanyị ike nʻoge gboo, o nwere ike ị lụrụ nwanyị ka ọ na-amụ nwa nʻaha ya na di ya, mana ugbu a i nwere ike kwụọ nwanyị ọzọ ụgwọ o buoro gị nwa gị nʻafọ ya, ọzọkwa bụ i ga na ngalaba gọọvụmentị na-afụ maka ụmụaka nne na nna ha anọghịzi, tinye akwụkwọ kute nwa	ime na-esiri nwanyị ike nʻoge gboo, o nwere ike ọ lụrụ nwanyị ka ọ na-amụ nwa nʻaha ya na nna ya, mana ugbu a o nwere ike kwụọ nwanyị ọzọ ụgwọ o buoro ya nwa ya nʻafọ ya, ọzọkwa bụ o nwere ike ga na ngalaba gọọvụmentị na-afụ maka ụmụaka nne na nna ha anọghịzi, tinye akwụkwọ kute nwa	0
ochuchu mmiri bụ otu nʻime ozi ezi na ụlọ na-amasị ụmụ agbọghọ maka na:	ichu mmiri na-adị ka  ịpụ ọrịrị, ị gawa, ị kpọrọ enyi gị ụnụ akpara nkata na-aga. Ụnụ lọtawa ụnụ eburu ite mmiri n'isi na-akụ asịrị ọ bụla na-ewu n'ogbe	ichu mmiri na-adị ka  ịpụ ọrịrị, ị gawa, ị kpọrọ enyi gị ụnụ akpara nkata na-aga. Ụnụ lọtawa ụnụ akpụrụ ite mmiri n'ala na-akụ asịrị ọ bụla na-ewu n'ogbe	0
kedu ụzọ dị iche iche e si enweta nkụ e i esi nri n'ala Igbo	e nwere ike inweta nkụ site na ị ba ọhịa chọtagasịa osisi kpọrọ nkụ dị n'ime ọhia ma ọ bụ bute osisi egbuturu egbutu ma ọ bụ alaka ya, ị lọta i nwere anyike waa ya.	e nwere ike inweta nkụ site na ị ba ọhịa chọtagasịa akwụkwọ kpọrọ nkụ dị n'ime ọhia ma ọ bụ bute osisi egbuturu egbutu ma ọ bụ alaka ya, ị lọta i nwere anyike waa ya.	0
egwumegwu ịwụ ụdọ bụ otu n'ime egwuregwu na-adị ụmụaka na ndị okenye mma n'ahụ n'ihi na:	ịwụ ụdọ gụnyere na mmadụ ga na-amali elu na amada. Nke a ga-eme ka ọbara na-agbasasị ma na-agbarisi nke ọma n'ime ahụ ma na-eme ka abụba adịghị mma gbarisie	ịwụ ụdọ gụnyere na mmadụ ga na-amali elu na amada. Nke a ga-eme ka ọbara na-agbasasị ma na-agbarisi nke ọma n'ime ahụ ma na-eme ka abụba  esighi ike gbarisie	0
ịkwa ụkwara na azụzụ ndị mmadụ na-arịakarị n'udu mmiri maka na:	mmiri na-ezo mgbe ọ bụla mere na ụbọchị na-ajụkawa oyi  nke nwere ike kpalie oyi ịba mmadụ ahụ	mmiri na-ezo mgbe ọ bụla mere na ụbọchị na-adịkawa ọkụ  nke nwere ike kpalie oyi ịba mmadụ ahụ	0
ịzụ nchọ bụ egwuregwu ndị Igbo mmadụ ga-ewetu anya n'ala mụta tupu mmadụ amalite zụwa nchọ maka na: 	ọ bụrụ na ị mataghị otu esi azụ nchọ, ị gaghị ama nke bụ ụlọ gị ma ọ bụ mgbe e riri okwe gị ma ọ bụ mgbe onye gị na ya na-azụ nchọ chọrọ ịghọgbu gị 	ọ bụrụ na ị mataghị otu esi azụ nchọ, ị gaghị ama nke bụ ụlọ gị ma ọ bụ mgbe e riri okwe gị ma ọ bụ mgbe onye gị na ya na-azụ nchọ chọrọ ịgbagbu gị 	0
imenwu ọkụ bụ ozi dịịrị onye na-esi nri nwere ụzọ dị iche iche e si eme ya dị ka:	iji abụrịba akwụ mkpaọkụ wee menwuo ọkụ ma ọ bụ ị ga n'agbata obi gụta ọkụ. Ụfọdụ ndị ji ego na-eji mmanụ keroziinu na mkpaọkụ were emenwu ọkụ	iji abụrịba nkwụ mkpaọkụ wee menwuo ọkụ ma ọ bụ ị ga n'agbata obi gụta ọkụ. Ụfọdụ ndị ji ego na-eji mmanụ keroziinu na mkpaọkụ were emenwu ọkụ	0
okpukpo ntụ ụtụtụ pụtara ihe yiri arụ n'ala Igbo ma emeghị ya were malite isi nri n'ihi na:	ọ na-adị nwa afọ Igbo ọ bụla nọ ebe ekpoghi ntụ wee malite isi nri ka onye e ij efere asaghị asa were tinyere nri	ọ na-adị nwa afọ Igbo ọ bụla nọ ebe ekpoghi nkụ wee malite isi nri ka onye e ij efere asaghị asa were tinyere nri	0
gịnị ka ikpo ntu na omenala ma ọ bụ ọdịnala Igbo pụtara?	Ikpo ntụ ụtụtụ  na omenala ma ọ bụ n'ọdịnala Igbo bụ  ikpochapụ ntụ ejiri sie nri na ụbọchị gara aga tupu amalite imenwu ọkụ maka osisi nri ọhụrụ	Ikpo ntụ ụtụtụ  na omenala ma ọ bụ n'ọdịnala Igbo bụ  ihichapụ ntụ ejiri sie nri na ụbọchị gara aga tupu amalite imenwu ọkụ maka osisi nri ọhụrụ	0
olee aha ọzọ mmadụ nwere ike ịkpọ nsị anyụrụ anyụ n'asụsụ Igbo?	nsị nwere aha di iche iche site n'onye nyụrụ ya. Ọkụkọ nyụọ nsị akpọọ ya akpana, ewu nyụọ nsi akpọọ akpụrụ. Mmadụ na anụmamụ ndị ọzọ nyụọ, etinye aha mmadụ ma ọ bụ aha anụmanụ wee kọwaa nsi onye ọ bụ.	nsị nwere aha di iche iche site n'onye nụrụ isi ya. Ọkụkọ nyụọ nsị akpọọ ya akpana, ewu nyụọ nsi akpọọ akpụrụ. Mmadụ na anụmamụ ndị ọzọ nyụọ, etinye aha mmadụ ma ọ bụ aha anụmanụ wee kọwaa nsi onye ọ bụ.	0
ịlụ ụlọ mposi agaala ije mgbanwe site na mgbe ochie ruo oge ọgbaraọhụrụ a dị ka:	i si na ị ga n'ọhịa na ị ga n'ụlọ mposi dị n'ọhịa gaa na ị ga na ị nyụnye nsị n'ime ite igwe na ị ga n'ụlọ mposi e gwuru egwu, mechaa gbanwerute na ị ga mposi n'ime ụlọ mposi arụnyere n'ime ụlọ.	i si na ị ga n'ọhịa na ị ga n'ụlọ mposi dị n'ọhịa gaa na ị ga na ị nyụnye nsị n'ime ite igwe na ị ga n'ụlọ mposi e gwuru egwu, mechaa gbanwerute na ị ga mposi n'ime ụlọ mposi arụnyere n'ime ọhịa.	0
gịnị ka mmadụ ga-eme ma ọ chọọ ikuku mgbe anwụ na-acha nke nchawa isi?	onye chọrọ ikuku mgbe anwụ na-acha ga-ebu ụzọ chọọ ebe ndo dị nọrọ wee chọkwazie akụpe ma ọ bụ akwụkwọ dị basabasa, na-apịagharị ya ihu na azụ ka o wee kpalie ikuku	onye chọrọ ikuku mgbe anwụ na-acha ga-ebu ụzọ chọọ ebe ndo dị nọrọ wee chọkwazie akụpe ma ọ bụ akwụkwọ dị mgbomgbo, na-apịagharị ya ihu na azụ ka o wee kpalie ikuku	0
ọkụkọ ubi agharala ọma agụ bụrụzie ugbo azụ ụlọ na ugbo akpa maka na:	ndị nwakpo na ndị omekaome na-akparazi ndị mmadụ aka ma ha gaa ọrụ ugbo n'ọma agụ ịkọ ihe	ndị nwakpo na ndị omekaome na-akparazi ndị mmadụ ụkwụ ma ha gaa ọrụ ugbo n'ọma agụ ịkọ ihe	0
olee ihe mere ndị mmadụ jizi akọnye ihe n'ime akpa karia n'ala?	enweghi ala e meela ndị mmadụ ka ha na-awụnye aja n'ime akpa were na-akọ ji, ọka, ji nwannu, akwụkwọ nri di iche iche. Ụfọdụ bụ maka ehi na-azọtọsị ma na-ata akpụ na ọka akọrọ n'ubi, ka ha jiri tinye isi n'iji akpa mere ubi	enweghi ala e meela ndị mmadụ ka ha na-āwụnye aja n'ime akpa were na-akọ ji, ọka, ji nwannu, akwụkwọ nri di iche iche. Ụfọdụ bụ maka ehi na-azọtọsị ma na-ata akpụ na ọka akọrọ n'ubi, ka ha jiri tinye ntị n'iji akpa mere ubi	0
owiwe ihe ubi di kitaa gbagwojuru anya buzikwa ọ chaghị acha gbute n'ihi na:	ezigbo agụụ dị n'obodo. Agụụ ekweghi onye kọrọ ihe chere ka ihe a kọrọ kaa aka. Ọzọ o nwenwuo ndidi chere, onye ọzọ agụụ ji eburu ya ụzọ ghọrọ ya. 	ezigbo agụụ dị n'ama. Agụụ ekweghi onye kọrọ ihe chere ka ihe a kọrọ kaa aka. Ọzọ o nwenwuo ndidi chere, onye ọzọ agụụ ji eburu ya ụzọ ghọrọ ya. 	0
olee otu mmadụ dị  ndụ chọrọ i nyere onwe ya aka ga-esi bido ma ọ  chọọ ị zụ ọkụkọ?	ị  chọọ ịzụ ọkukọ. ị  gaa ebe a na-ere ụmụ ọkukọ zụrụ obere ụmụ ọkụkọ, ị  lọta ị  nwụnye ha na mkpọ ọkukọ, mụnyere ha ọkụ, tinyere ha nri ma nwụnyere ha ọgwụ na mmiri ha ga na-anụ	ị  chọọ izụ ọkukọ. ị  gaa ebe a na-ere ụmụ ọkukọ zụrụ obere ụmụ ọkụkọ, ị  lọta ị  nwụnye ha na mkpọ ọkukọ, sonyere ha nkụ, tinyere ha nri ma nwụnyere ha ọgwụ na mmiri ha ga na-anụ	0
ise agidi fụrụ afụ ma dịkwa mma oriri esighi ike ma ọlị maka na:	ọ bụ naanị  ị mata ọka, kwọọ ma yọọ ya, i mee ya ka akamụ malite sewe ya n'elu ọkụ ruo mgbe ọrọkọrọ ọnụ, sie ike. I kunyeya n'akwụkwọ unere kechie ma rapụ ya ka ọ jụọ oyi.	ọ bụ naanị  ị mata agwa, kwọọ ma yọọ ya, i mee ya ka akamụ malite sewe ya n'elu ọkụ ruo mgbe ọrọkọrọ ọnụ, sie ike. I kunyeya n'akwụkwọ unere kechie ma rapụ ya ka ọ jụọ oyi.	0
obibi ugwu bụ omenala ndị Igbo na ndị ụlọ ọgwụ bekee nwekọrọ mere na ị bịa n'ụlọ ọgwụ:	a mụọ nwa, ọ gaa abalị asatọ, e kuru nwa ahụ gaghachi n'ụlọ ọgwụ, e were ọla gbara okirkiri gbanye nwa nwoke ahụ n'ọnụ amụ, nyezie nne ya ọgwụ ọ ga na-enye ya maka ụfụ ọnya. Mgbe abalị atọ gara, ọla ahụ na ahụ izizi ya ga-adapụ	a mụọ nwa, ọ gaa abalị asatọ, e kuru nwa ahụ gaghachi n'ụlọ ọgwụ, e were ọla gbara okirkiri gbanye nwa nwoke ahụ n'ọnụ amụ, nyezie nne ya ọgwụ ọ ga na-enye ya maka ụfụ ọnya. Mgbe abalị atọ gara, ọla ahụ na ahụ izizi ya ga-amado	0
esemokwu nwegasịrị uzo dị iche iche e ji egosiputa ya dị ka:	ibu ihu, egheghi mmadụ ọnụ, mgbakasị ahụ ma onye ọ bụ gị na ya bata, ịkọ ọnụ, ịlụ ọgụ,ekworo na obi ọjọọ dị iche iche	ibu ihu, egheghi mmadụ ọnụ, mgbakasị ahụ ma onye ọ bụ gị na ya bata, ịkọ agba, ịlụ ọgụ,ekworo na obi ọjọọ dị iche iche	0
olee otu ụmụ akwụkwọ na-aga akwụkwọ mgbe akụbigoro mgbịrịmgba ụtụtụ si azọ ije?	ha na-eburu akpa ha n'isi ma ọ bụ koro ya n'azụ, nwere nnwennwe ọsọ na-agbaga ụlọ akwụkwọ ma were uche na-agbakọ otu ha ga esi nagide ụtarị abịaghị gboo	ha na-eburu akwa ha n'isi ma ọ bụ koro ya n'azụ, nwere nnwennwe ọsọ na-agbaga ụlọ akwụkwọ ma were uche na-agbakọ otu ha ga esi nagide ụtarị abịaghị gboo	0
olee ihe mmadụ na-ebu ụzọ emekarị n'ụtụtụ ma o mepee anya  n'elu akwa chọpụta na ọ nwụghị  n'abalị?	ọ na-esekpuru ala kelee chineke dowere ya ndụ ma kulie ga taa atụ ụtụtụ, gbatịa onwe ya, gaa ozi ụtụtụ tupu ọ saa ahụ ma rikwaa nri ụtụtụ	ọ na-esekpuru ala kelee chineke dowere ya ndụ ma kulie ga taa atụ ụtụtụ, gbakọọ onwe ya, gaa ozi ụtụtụ tupu ọ saa ahụ ma rikwaa nri ụtụtụ	0
ịhụ onye ọrụ aka dị ka onye ọgba ọsọ, onye bọọlụ, onye ogwu mmiri n'ihe ọ  na-eme na-amara ya ahụ kwa ụbọchị: 	ọ ga-agba mbọ na-anwale onwe ya ọtụtụ awa n'ụbọchị, ọtụtụ ụbọchị n'ime izu, ọtụtụ izu n'ime ọnwa, ọtụtụ ọnwa n'ime ahọ nakwa ọtụtụ ahọ n'oge ndụ ya niile  	ọ ga-agba mbọ na-anwale onwe ya ọtụtụ awa n'ụbọchị, ọtụtụ ụbọchị n'ime izu, ọtụtụ izu n'ime ọnwa, ọtụtụ ọnwa n'ime izu nakwa ọtụtụ ahọ n'oge ndụ ya niile  	0
olee otu ndị dibịa bekee si agba mbọ ị hụ na ha adabanyeghị na nsogbu ọ bụla ebe ha na-arụ ọrụ?	ha na-akpachapụ anya hụ n'ihe ha chọrọ ime n'ahụ mmadụ ọ bụla bụ ihe doro ha anya nke ọma ma nwekwaa ngwa ọrụ zuru ezu. Ha naēsonyekwara usoro ọrụ niile e dooro ha iji elekọta ndị ọrịa.	ha na-akpachapụ anya hụ n'ihe ha chọrọ ime n'ahụ mmadụ ọ bụla bụ ihe doro ha anya nke ọma ma nwekwaa ngwa ọrụ zuru ezu. Ha na-esonyekwara usoro ọrụ ụfọdụ e dooro ha iji elekọta ndị ọrịa.	0
osisi akwụkwọ dịwaga iche na osisi nri ọzọ dị iche iche a na-esi maka na:	i sitee akwụkwọ nri aka, i sichuo ihe na-enye ndụ dị ya n'ime . A naghị esite akwụkwọ nri aka. Ị metụ ya n'ọkụ n̄aran̄ara, ị fọtuo ya	i sitee akwụkwọ nri aka, i sichuo ihe na-anapụ ndụ dị ya n'ime . A naghị esite akwụkwọ nri aka. Ị metụ ya n'ọkụ n̄aran̄ara, ị fọtuo ya	0
olee otu e si egbu ọkụkụ mmadụ gotere n'ahịa maka oriri?	ị nwụta ọkụkọ ahụ, ị pịakọọ nku ya abụọ ọnụ were ụkwụ pịdo ya n'ala, ị dọtịa isi ọkụkọ ahụ fee azụ, jide isi ya ma were aka dọchasịa ugbene ọkụkụ dị ya n'olu, were mma bepuo ya akpịrị, hapụtụ ya ka ọ gbaa tịkọtịkọ nwọọ	ị nwụta ọkụkọ ahụ, ị pịakọọ nku ya abụọ ọnụ were ụkwụ pịdo ya n'ala, ị dọtịa isi ọkụkọ ahụ fee azụ, jide isi ya ma were aka dọchasịa ugbene ọkụkụ dị ya n'olu, were mma bepuo ya akpịrị, hapụtụ ya ka ọ gbaa tịkọtịkọ gbafuo	0
olee etu e si abọ anụ ọkụkọ mmadụ gbuchagoro egbucha?	ị ga-atụnye ya na mmiri ọkụ kpagharịa ya nwa oge ka ugbene ya were kwe pụọ  n'arụ ya, i mechaa ya, saa ya mmiri, dote ya  n'elu tebulu were mma bepụ ya olu, bepụ apata ụkwụ ya abụọ, si  n'afọ bọọ ya, wepụ olulu ilo ya tufuo, bewaa eke ya kpochaa, si  n'akpịrị wepụ akpa nri ya ma berizie anụ ndị ọzọ	 ga-abanye ya na mmiri ọkụ kpagharịa ya nwa oge ka ugbene ya were kwe pụọ  n'arụ arụ, i mechaa ya, saa ya mmiri, dote ya  n'elu tebulu were mma bepụ ya olu, bepụ apata ụkwụ ya abụọ, si  n'afọ bọọ ya, wepụ olulu ilo ya tufuo, bewaa eke ya kpochaa, si  n'akpịrị wepụ akpa nri ya ma berizie anụ ndị ọzọ	0
nkwado na osisi ofe akwụ abụghị maka ụmụaka maka na:	ị ga-ebu ụzọ  sie akwụ, sụọ ya n'ikwe ma o ghee, gbaa ya gbapụta akwụ, wụnye ya n'ite sinye ya n'ọkụ, ọ sụọ ị kwakọnye ya ihe nri dị ka yabaasị, ose, nchụanwụ, ịsha, azụ ọkpọọ, anụ na ogiri okpei	ị ga-ebu ụzọ  sie akwụ, sụọ ya n'ikwe ma ọ chaa, gbaa ya gbapụta akwụ, wụnye ya n'ite sinye ya n'ọkụ, ọ sụọ ị kwakọnye ya ihe nri dị ka yabaasị, ose, nchụanwụ, ịsha, azụ ọkpọọ, anụ na ogiri okpei	0
kedu ka e si eru ube ma mmadụ chọọ ị racha ube ma ọ bụ were ya taa ọka?	e nwere ụzọ dị iche iche  e si  eru ube. A ghọtachaa ube ojii, e sie mmiri ọkụ, ọ sụọ, a wụnye ube ahụ nʻime ya kwuchie ya ka o ruo. Ọ dịtụ nwa obere oge, a gụpụta ya ma ọ bụ ị nọrọ ebe a naēse nri na nkụ, i kporo ntụ ọkụ kpokwasị nʻelu ube hapụ ya ka ntụ ọkụ ahụ ruo ya.	e nwere ụzọ dị iche iche  e si  eru ube. A ghọtachaa ube ojii, e sie mmiri ọkụ, ọ sụọ, a wụnye ube ahụ nʻime ya kwuchie ya ka o ruo. Ọ dịtụ nwa obere oge, a gụpụta ya ma ọ bụ ị nọrọ ebe a naēse nri na nkụ, i kporo ntụ ọkụ kpokwasị nʻelu ube hapụ ya ka icheku ọkụ ruo ya.	0
ọn̄ụn̄ụ mmiri bụ ihe onye ọ bụla  chọrọ ibi ogologo ndụ na-achọ maka na:	onye ọ bụla na-an̄ụchite mmiri anya na-edo ahụ maka na ahụ ya agaghị akpọ nkụ, mgbịrị afọ na umeju ga na-adị ọcha mgbe niile	onye ọ bụla na-an̄ụchite mmiri anya na-edo ahụ maka na ahụ ya agaghị akpọ nkụ, mgbịrị afọ na umeju ga na-eru unyi mgbe niile	0
olee otu nwatakịrị enweghị eze elu ma ọ bụ eze ala si ata ibe achịcha bekee?	nwata epubeghi eze chọọ ịta ibe achịcha bekee, ọ na-ebu ụzọ guo ibe achịcha ọnụ mmiri ka o dee, o werezie igbudu ya na-echiritụ ya na-elo	nwata epubeghi eze chọọ ígwē ibe achịcha bekee, ọ na-ebu ụzọ guo ibe achịcha ọnụ mmiri ka o dee, o werezie igbudu ya na-echiritụ ya na-elo	0
mgbe mmadụ tetara ụra ma dinejie olu, o nwere otu e si emezi ya ka ọ dịkwa mma, nke bụ:	i jide onye ahụ dinejiri olu, mee ya ka ọ nọrọ ala, i were otu aka budo azụ isi ya were nke ọzọ budo agba ya. Mgba mbọ hụ na ị kwụ ọtọ bulite isi ahụ elu obere dọtia ya elu, aka nri na aka ekpe	i jide onye ahụ dinejiri olu, mee ya ka ọ nọrọ ala, i were otu aka budo azụ isi ya were nke ọzọ budo ara ya. Mgba mbọ hụ na ị kwụ ọtọ bulite isi ahụ elu obere dọtia ya elu, aka nri na aka ekpe	0
iti akị agbapụtara nʻakwụ bụ ihe ezi na ụlọ Igbo ọ bụla maara eme bụ:	i weta akị agbachapụtara nʻakwụ ma gbaa ya n'anwụ ka ọ kpọọ, i dota ya nʻelu nkume ma chọta okwute siri ike nke anaghị itiwasị etiwasị, ị tie nʻelu akị ahụ, o tiwaa, i were akị gị, kpochapụ ichere.	i weta akị agbachapụtara nʻakwụ ma gbaa ya n'anwụ ka ọ kpọọ, i dota ya nʻelu nkume ma chọta okwute siri ike nke anaghị itiwasị etiwasị, ị tie nʻelu akị ahụ, o tiwaa, i were akị gị, kpochapụ abụrịbụ.	0
olee otu e si agba ntị mgbe gboo ma ime ntị kọwa mmadụ ọkọ?	ntị kọwa mmadụ ọkọ na mgbe gboo, ọ chọọ ugbene ọkụkụ toro ogo wee gbaa ntị mana ọ hụghị ugbene, o tinye mkpịsị aka nʻnti ya man̄aa ya elu na ala	ntị kọwa anụmanụ ọkọ na mgbe gboo, ọ chọọ ugbene ọkụkụ toro ogo wee gbaa ntị mana ọ hụghị ugbene, o tinye mkpịsị aka nʻnti ya man̄aa ya elu na ala	0
nwata akwụkwọ mee mkpọtụ n'ụlọ akwụkwọ, e were ụzọ dị iche iche e si agbaziri ya ụzọ dị ka:	onye nkuzi nwere ike ị kwụwa ya ọtọ n'elu oche, sekpube ya ala, kenye ya ọrụ ịsụ ahịhịa  ma ọ bụ pịa ya ụtarị	onye nkuzi nwere ike ị kwụwa ya ọtọ n'elu oche, kwe ya nʻaka, kenye ya ọrụ ịsụ ahịhịa  ma ọ bụ pịa ya ụtarị	0
nwata nwanyị na-etopụta etopụta chọọ inweta ezigbo di ga-alụ ya, 	ọ ga-agba mbọ nwee ezi agwa, nwee ihu ọchị, na-edebe onwe ya na ebe obi ọcha ma mụtakwa ka e si esi nri ọfụma.	ọ ga-agba mbọ nwee ajọ agwa, nwee ihu ọchị, na-edebe onwe ya na ebe obi ọcha ma mụtakwa ka e si esi nri ọfụma.	0
kedu ka onye chọọ iri ikpo ogede ga e si sie ya ka ọ tọọ ụtọ ma dị mma oriri?	ị chọọ iri ikpo ogede, i chọọ ogede anọ ma ọ bụ ise chatọrọ achatọ, mefụọ tinye nʻikwe ma kwọtọọ ya akwọtọ. I tinye ya ose, ịsha, nnu na yabaasị, tanye ya mmanụ Igbo ga-atụ ya ọfụma,tinyetụ obere mmiri, gwakọrịta ha niile ọnụ, kuo ma kee ha nʻakwụkwọ ogede sinye nʻọkụ, o ghee, ị fọtuo ya 	ị chọọ iri ikpo unere, i chọọ ogede anọ ma ọ bụ ise chatọrọ achatọ, mefụọ tinye nʻikwe ma kwọtọọ ya akwọtọ. I tinye ya ose, ịsha, nnu na yabaasị, tanye ya mmanụ Igbo ga-atụ ya ọfụma,tinyetụ obere mmiri, gwakọrịta ha niile ọnụ, kuo ma kee ha nʻakwụkwọ ogede sinye nʻọkụ, o ghee, ị fọtuo ya 	0
nwataịrị chọrọ ịracha unere ma o kweghi ya mmefụ ga-ebu ụzọ mụta ka e si emefụ unere dị ka:	ị chọọ imefụ unere, i buru ụzọ kata unere nʻajụ unere, i si nʻebe isi ya kajie ya, dọdaa azụ unere ahụ ị kajipụtara ala, i sikwa nʻakụkụ ọzọ dodakwa ya ruo nʻetiti ruo mgbe ime ya niile pụtara, ị riwe unere gị	ị chọọ imefụ unere, i buru ụzọ kata unere nʻajụ unere, i si nʻebe etiti ya kajie ya, dọdaa azụ unere ahụ ị kajipụtara ala, i sikwa nʻakụkụ ọzọ dodakwa ya ruo nʻetiti ruo mgbe ime ya niile pụtara, ị riwe unere gị	0
olee otu nwanyị si etinye nwa nʻazụ ka ọ kwụsị ibe akwa ma ọ bụ ka ọ rahụ ụra?	nwanyị ahụ ga-achọta ọgọdọ siri ike, too ogologo ijezu okirikiri ya ọfụma ma saa mbara ikechidonwu nwata ahụ n'azụ ya. Nwanyị ga-egbo ọgọdọ ahụ nʻukwu ya, hukpulata ala, kuru nwa ya kufee azụ ma welie ọgọdọ ahụ elu machie nwa ya, kechie ya nʻelu ara ya. nwanyị ahụ kwụrụ ọtọ ọfụma, o nwekwara ike kechie ọgọdọ ahụ nʻokpuru ka o wee sie ike	nwanyị ahụ ga-achọta ọgọdọ siri ike, too ogologo ijezu okirikiri ya ọfụma ma saa mbara ikechidonwu nwata ahụ n'azụ ya. Nwanyị ga-egbo ọgọdọ ahụ nʻisi ya, hukpulata ala, kuru nwa ya kufee azụ ma welie ọgọdọ ahụ elu machie nwa ya, kechie ya nʻelu ara ya. nwanyị ahụ kwụrụ ọtọ ọfụma, o nwekwara ike kechie ọgọdọ ahụ nʻokpuru ka o wee sie ike	0
nne nwanyị ọ bụla chọrọ isi nri were ụzọ dị iche iche o si akwado ose ọ ga-etinye na nri ahụ dị ka:	isu ose nʻọkwa, ịkwọ ose nʻokwute e ji egwe nri, ịkwọ ya nʻigwe ọgbara ọhụrụ e ji akwọ ihe ma ọ bụ iji mma berisịa ose ndị ahụ wụnye nʻite	isu ose nʻọkwa, ịkwọ ose nʻokwute e ji eri nri, ịkwọ ya nʻigwe ọgbara ọhụrụ e ji akwọ ihe ma ọ bụ iji mma berisịa ose ndị ahụ wụnye nʻite	0
kedu otu e si atụcha agwa ahịhịa na aja juru nke amapụtara maka isi esi?	ị chọọ ịtụcha agwa ahịahịa na aja juru, ị mapụta ya nʻime efere dị mbamba, jide mbadamba efere ahụ nʻakụkụ ya abụọ, na-akpalitụ ya elu ka agwa dị nʻime ya na-awụgharị. Ahịhịa na-apụta, i were ọnụ na-afụchapụ ya. I mesịa nke a, i were nwayọ tụtụwa agwa ahụ na-ahọchapụ aja na okwute	ị chọọ ịtụcha agwa ahịahịa na aja juru, ị mapụta ya nʻime efere dị mbamba, jide mbadamba efere ahụ nʻakụkụ ya abụọ, na-akpalitụ ya elu ka agwa dị nʻime ya na-awụgharị. Ahịhịa na-apụta, i were ọnụ na-afụchapụ ya. I mesịa nke a, i were nwayọ tụtụwa agwa ahụ na-ahọchapụ aja na okwute	0
olee etu mmadụ ga-esi mara ji ọcha ma ọ chọrọ ịzụta ji ọcha nʻahịa?	onye amaghị ụdịka ji enweghi ike isi nʻazụ ji mara nke bụ ji ọcha na nke were ike ịgbaji oji ma e bechaa ya. Ị chọọ ịzụta ji ọcha, i buru tụọ ji i chọrọ ịzụ obere mbọ, tupuo ma cheretụ nwa oge. Ebe ahụ i tupuru gbajie, ọ bụghị ji ọcha.	onye amaghị ụdịka ji enweghi ike isi nʻime ji mara nke bụ ji ọcha na nke were ike ịgbaji oji ma e bechaa ya. Ị chọọ ịzụta ji ọcha, i buru tụọ ji i chọrọ ịzụ obere mbọ, tupuo ma cheretụ nwa oge. Ebe ahụ i tupuru gbajie, ọ bụghị ji ọcha.	0
nwa agbọghọ ọ bụla bịara mmemme na-akwụtịzi akwụtí topu maka na:	ndị na-arụ akpụkpọ ụkwụ ụmụ nwanyị emepụtala ndị hachaa ka ụlọ elu. Ị hụ nwanyị chọọ ị mara ka ọ ha nʻogologo, buru ụzọ lee ya anya nʻụkwụ, i wepụ ogologo akpụkpọ ụkwụ ya, nke fọdụrụ bụzi ogo ya	ndị na-arụ akpụkpọ ụkwụ ụmụ nwanyị emepụtala ndị hachaa ka ụlọ elu. Ị hụ nwanyị chọọ ị mara ka ọ ha nʻogologo, buru ụzọ lee ya anya nʻụkwụ, i wepụ ogologo akpụkpọ ụkwụ ya, nke fọdụrụ abụghi ogo ya	0
olee  ihe onye anya na-egbu ma ọ bụ onye ejighizi anya ya agụta ihe edere nʻakwụkwọ kwesịrị ime?	onye nwere ụdịka nsogbu a ga-aga ụlọ ọgwụ maka anya hụ dọkịta anya. O lechaa ya anya, o nwere ike nye ọgwụ ọ ga na-atụ nʻanya ma chọkwaara ya ugegbe anya ga-adị anya ya mma. 	onye nwere ụdịka nsogbu a ga-aga ụlọ ọgwụ maka anya hụ dọkịta anya. O lechaa ya anya, o nwere ike nye ọgwụ ọ ga na-atụ nʻanya ma chọkwaara ya ugegbe ihu ga-adị anya ya mma. 	0
ụmụ nwanyị nwere ụdịrị akpa dị iche iche ha na-eko ha ji aga ụfọdụ ebe dị ka: 	ụmụ nwanyị koro nnukwu akpa, mara na ha na-eje ahịa ma ọ bụ akwụkwọ, ha e koro nke ebutughi ibu, ị mara na ọ bụ ụlọ ụka ma ọ bụ nzụkọ mana ụfọdụ ụmụ nwanyị gawa mmemme ọ kacha nke agbam akwụkwọ, ha na-eji ntakịrị akpa na-erite naanị igodo ụgbọala ha ya na ego ha ji bịa mmemme ahụ 	ụmụ nwanyị koro nnukwu akpa, mara na ha na-eje ahịa ma ọ bụ akwụkwọ, ha e koro nke ebutughi ibu, ị mara na ọ bụ ụlọ ụka ma ọ bụ nzụkọ mana ụfọdụ ụmụ nwanyị gawa mmemme ọ kacha nke agbam akwụkwọ, ha na-eji ntakịrị akpa na-erite naanị igodo ụgbọala ha ya na akwa ha ji bịa mmemme ahụ 	0
azụzụ na ụkwara suchiri mmadụ imi na obi were ụzọ e si a nwapụta ya dị ka:	i tee ude azụzụ na-ekpo ekpo nʻazụ ntị, elu imi, obi na egedege ihu ma ọ bụ kpuo mmiri ọkụ, taa ụtazị ma ọ bụ mmịmị, ụkwara na azụzụ suchiri ịmi na obi ga-agbaze, ị nwaa ya, nwapụta ya, bụfuo. Ị nwekwara ike pịchie otu oghere imi zipụ imi ma mekwa otu ahụ nʻoghere imi nle ọzọ	i tee ude isi na-ekpo ekpo nʻazụ ntị, elu imi, obi na egedege ihu ma ọ bụ kpuo mmiri ọkụ, taa ụtazị ma ọ bụ mmịmị, ụkwara na azụzụ suchiri ịmi na obi ga-agbaze, ị nwaa ya, nwapụta ya, bụfuo. Ị nwekwara ike pịchie otu oghere imi zipụ imi ma mekwa otu ahụ nʻoghere imi nle ọzọ	0
olee onye ga-aka amụtakarị ihe akụziri, onye bịara akwụkwọ ma kọpịa ihe onye nkuzi dere ka ọ bụ onye yọtara akwụkwọ e ji kọpịa ihe ma gụọ ya nke ọma?	 onye ga aka mụtakarị ihe akụziri bụ onye bịara akwụkwọ ma kọpịa ihe onye nkuzi dere maka na ọ bụghị naanị na ọ kọpịrị ya kama ọ nọọ mgbe onye nkuzi na-akọwa ihe ahụ	 onye ga aka mụtakarị ihe akụziri bụ onye bịara akwụkwọ ma kọpịa ihe onye nkuzi dere maka na ọ bụghị naanị na ọ kọpịrị ya kama ọ nọghị mgbe onye nkuzi na-akọwa ihe ahụ	0
nwata zara ụlọ na nke sara efere enweghị onye ka nne ya mkpa maka na: 	onye zara ụlọ doziri ya ka ọ dị mma ịnọ nakwa ịnabata ndị ọbịa. Onye nke sara efere gbalịkwara debe efere ọcha maka iji rie nri na ichere ndị ọbịa ọjị. Ụmụ aka baara nne ha uru nke ukwuu.	onye zara ụlọ doziri ya ka ọ dị mma ịnọ nakwa ịnabata ndị ara. Onye nke sara efere gbalịkwara debe efere ọcha maka iji rie nri na ichere ndị ọbịa ọjị. Ụmụ aka baara nne ha uru nke ukwuu.	0
ịn̄ụ mmiri mgbe ọ bụla ka ịn̄ụ mmanya na-aba nʻanya wee ba uru maka na:  	onye ọ bụla na-an̄ụ mmiri na-edozi ahụ ya, o nweghikwa ihe an̄ụghị mmanya napụrụ ya mana onye na-an̄ụ mmanya ọkachasị nke na-aba nʻanya na-an̄ụghị mmiri che aka ghọrọ ọrịa ntụmadụ	onye ọ bụla na-an̄ụ mmiri na-edozi ahụ ya, o nweghikwa ihe an̄ụghị mmanya napụrụ ya mana onye na-an̄ụ mmanya ọkachasị nke na-aba nʻọnụ na-an̄ụghị mmiri che aka ghọrọ ọrịa ntụmadụ	0
kedu ka e si asa azụ ite e siri na nkụ nke unyi metọsịrị?	ụfọdụ ji ntụ awụkọrọ ya nʻajịrịjị ncha na ogbo were echi azụ ite e siri na nkụ, ụfọdụ na-eji ncha ajịrịjị na aja, ndị ọzọ na-eji akwụkwọ pọpọ, aja na ntụ ma ọ bụ asịsa igwe na ncha. Ha metụ mmiri na ogbo, dere aja, ntụ na ncha, ha echie azụ ite ahụ chichapụ unyi ahụ ma were mmiri dị ọcha n̄achapụ ya.	ụfọdụ ji ntụ awụkọrọ ya nʻajịrịjị ncha na ogbo were echi azụ ite e siri na nkụ, ụfọdụ na-eji ncha ajịrịjị na aja, ndị ọzọ na-eji akwụkwọ pọpọ, aja na ntụ ma ọ bụ asịsa igwe na ncha. Ha metụ mmiri na ogbo, dere asọ mmiri, ntụ na ncha, ha echie azụ ite ahụ chichapụ unyi ahụ ma were mmiri dị ọcha n̄achapụ ya.	0
olee otu e si ekowe foto nne na nna ma ọ bụ nke ụmụ ha nʻahụ aja?	ị ga-agba hụ nʻoghere dị nʻetiti azụ foto ahụ nʻebe elu ya, i werezie ntu ma ọ bụ ihe e ji aghụpu aja gaa ebe ị chọrọ i kowe foto ahụ kpọpuo ma ọ bụ kụbatụnye ntu ebe ahụ ma were azụ foto ahụ konye ntu ahụ nʻoghere ahụ ma hazie ya ka ọ gbabere ọfụma.	ị ga-agba hụ nʻoghere dị nʻetiti azụ foto ahụ nʻebe elu ya, i werezie ntu ma ọ bụ ihe e ji aghụpu aja gaa ebe ị chọrọ i kowe foto ahụ kpọpuo ma ọ bụ kụbatụnye ntu ebe ahụ ma were azụ foto ahụ konye ntu ahụ nʻoghere ahụ ma hazie ya ka ọ dinere ọfụma.	0
olee ụdịka ihe na-ekonyegasị nʻahụ aja ebe mmadụ na ezi na ụlọ ya bi?	ị bata ebe mmadụ na ezi na ụlọ ya bi, ihe na-ekokarị nʻelu aja bụ foto agbam akwụkwọ nwoke bi ụlọ na nwunye ya, ị ga-ahụkwa foto ụmụaka ha mụrụ. Mgbe ụfọdụ ị ga-ahụ akwụkwọ kalịịnda maka ngosipụta ụbọchị, izu, ọnwa na afọ ya na eserese ndị ọzọ e ji achọ ụlọ mma.	ị bata ebe mmadụ na ezi na ụlọ ya bi, ihe na-ekokarị nʻelu ụlọ bụ foto agbam akwụkwọ nwoke bi ụlọ na nwunye ya, ị ga-ahụkwa foto ụmụaka ha mụrụ. Mgbe ụfọdụ ị ga-ahụ akwụkwọ kalịịnda maka ngosipụta ụbọchị, izu, ọnwa na afọ ya na eserese ndị ọzọ e ji achọ ụlọ mma.	0
nlete onye ọrịa bụ ọrụ onye nwere ndidi, ihunanya ma dị ike ọrụ na arụ nʻihi na:	i nwere ike sichaa ezigbo nri, onye ọrịa metụ ya ọnụ , ọ sị na ọ na-ahụ ya agbọọ, ma ọ bụ na ọ chọzighị iri nke ahụ na ọ bụ ihe ọzọ na-agụ ya. Ụfọdụ ga-agbalị rie mana ngwa ngwa ha richara nri, ha asaghee ọnụ gbọsara gị nri ahụ nʻala ụlọ. I jideghi onwe gị aka, iwe abịa gị.	i nwere ike sichaa ezigbo nri, onye ọrịa metụ ya ọnụ , ọ sị na ọ na-ahụ ya agbọọ, ma ọ bụ na ọ chọzighị iri nke ahụ na ọ bụ ihe ọzọ na-agụ ya. Ụfọdụ ga-agbalị rie mana ngwa ngwa ha richara nri, ha asaghee ọnụ gbọsara gị nri ahụ nʻala ụlọ. I jideghi onwe gị aka, iwe abịa gị.	0
olee ụdịrị aha a na-etugasị chineke ma a na-aja ya mma nʻụlọ ụka ma ọ bụ nʻoge ekpere?	mgbe gara aga, a na-etu ya naanị aha dị nʻime akwụkwọ nsọ mana ugbu a, ndị mmadụ na-etuzi chineke aha miri emi dị ka eze ebube, chukwu ọma, oje na mmụọ, ntụntụ mmiri tụjiri ogwe na ụta gbawara ili. Aha ndị a na-egosipụta ihe ọ na-eme na ndụ ndị mmadụ.	mgbe gara aga, a na-etu ya naanị aha dị nʻime akwụkwọ ukwe mana ugbu a, ndị mmadụ na-etuzi chineke aha miri emi dị ka eze ebube, chukwu ọma, oje na mmụọ, ntụntụ mmiri tụjiri ogwe na ụta gbawara ili. Aha ndị a na-egosipụta ihe ọ na-eme na ndụ ndị mmadụ.	0
ịdị ime na ịmụ nwa na-agbanwe ọtụtụ akụkụ ahụ nwanyị mara mma dị ka:  	nwanyị dị ime, o ruwe ọnwa ise na-agbagote, afọ nwanyị etopute, ara na ụkwụ ya azaa, imi ya ekoo, o nwekwara iji gbajie ezigbo oji. Ọ mụzie nwa, afọ ya adalata ma ọ gaghị adịzi otu ọ dị mgbe ọ nụbeghi di, ara ya ebuo maka mmiri ara. O na-ebukwa ibu maka nri ọ na-eri iji wee na-eme ka mmiri ara na-agba ọfụma. 	nwanyị dị ime, o ruwe ọnwa iri na-agbagote, afọ nwanyị etopute, ara na ụkwụ ya azaa, imi ya ekoo, o nwekwara iji gbajie ezigbo oji. Ọ mụzie nwa, afọ ya adalata ma ọ gaghị adịzi otu ọ dị mgbe ọ nụbeghi di, ara ya ebuo maka mmiri ara. O na-ebukwa ibu maka nri ọ na-eri iji wee na-eme ka mmiri ara na-agba ọfụma. 	0
olee ihe ndị na-adị nʻakwụkwọ ozi e dere, chọọ izigara mmadụ nọ obodo ọzọ ?	ihe ndị na-adị nʻakwụkwọ ozi e dere, chọọ izigara mmadụ nọ obodo ọzọ bụ isiokwu ozi ahụ, aha onye dere ozi ahụ na nke kacha mkpa bụ aha onye a na-edegara akwụkwọ ozi ahụ, obodo o bi nakwa akara adịreesị ya	ihe ndị na-adị nʻakwụkwọ ozi e dere, chọọ izigara mmadụ nọ obodo ọzọ bụ isiokwu ozi ahụ, aha onye dere ozi ahụ na nke kacha mkpa bụ aha onye a na-edegara akwụkwọ ozi ahụ, obodo o bi nakwa akara ekwentị ya	0
olee otu e si agbanyụ ọkụ bọọlụbụ  eletiriiki na-enwu nʻime ụlọ ma chi fo?	ị chọọ ịgbanyụ ọkụ bọọlụbụ  eletiriiki na-enwu nʻime ụlọ ma chi fo, ị gaa nʻime ụlọ ebe bọọlụbụ ahụ na-enwu, i bata i legharịa anya nʻahụ aja mara ma ihe ga-ahụ ihe dị ka ibe okwuchi, ị hụ ya, ị metụ ọdụ mgbali elu na mgbada ala dị nʻelu ya aka ma na-ele bọọlụbụ ahụ anya. mgbe ọ bụla ị kpatụrụ nke e ji agbanyụ ya aka, ọkụ ahụ anyụọ. 	ị chọọ ịgbanyụ ọkụ bọọlụbụ  eletiriiki na-enwu nʻime ụlọ ma chi fo, ị gaa nʻime ụlọ ebe bọọlụbụ ahụ na-enwu, i bata i legharịa anya nʻahụ aja mara ma ihe ga-ahụ ihe dị ka ibe okwuchi, ị hụ ya, ị metụ ọdụ mgbali elu na mgbada ala dị nʻelu ya aka ma na-ele bọọlụbụ ahụ anya. mgbe ọ bụla ị kpatụrụ nke e ji agbanyụ ya ụkwụ, ọkụ ahụ anyụọ. 	0
olee otu ahụ ndị bi nʻíme obodo di iche iche dị na Naijirịa sị acha?	ụfọdụ ndị bi na Naịjirịa dị ezigbo ọcha, ụfọdụ dịnwa oji, ụfọdụ na-egbu maramara, ụfọdụ bụrụ anyarị mana ndị bi nʻọwawa anyanwụ, ọdịda anyanwụ na ebe oke mmiri na-achakarị ọcha karịa ndị bi nʻugwu	ụfọdụ ndị bi na Naịjirịa dị ezigbo ọcha, ụfọdụ dịnwa oji, ụfọdụ na-egbu maramara, ụfọdụ bụrụ anyarị mana ndị bi nʻọwawa anyanwụ, ọdịda anyanwụ na ebe oke mmiri na-ejikarị oji karịa ndị bi nʻugwu	0
nwoke eweghi ihe jikọrọ gị na ya nọkata wetawara nwanyị ihe onyinye dị iche iche, ya bụ na:	o nwere ike nwoke ahụ achọọ ịlụ nwanyị ahụ alụ ma ọ bụ imeta ya enyị ma nke were anya bụ na uche ya dị na ebe nwanyị ahụ nọ	o nwere ike nwoke ahụ achọọ ịlụ nwanyị ahụ alụ ma ọ bụ imeta ya onye iro ma nke were anya bụ na uche ya dị na ebe nwanyị ahụ nọ	0
kedu ihe mmadụ ga-abụ o mee a sị na o nwere ọmịiko na ara ebere?	 ihe mmadụ ga-abụ o mee a sị na o nwere ọmịiko na ara ebere bụ na ihe mere mmadụ ibe ya na-emetụta ya rinne. Mmadụ nọrọ na mkpa, o nyere onye ahụ aka agbanyeghi ma ọ ma onye ahụ ma ọ maghị. A kọtara ya ihe, o tinye onwe ya nʻọnọdụ onye na-akọ ya ma ghọta, nye onye ahụ ụsa ga-ebutu ya obi.	ihe mmadụ ga-abụ o mee a sị na o nwere ọmịiko na ara ebere bụ na ihe mere mmadụ ibe ya na-emetụta ya rinne. Mmadụ nọrọ na mkpa, o nyere onye ahụ aka agbanyeghi ma ọ ma onye ahụ ma ọ maghị. A kọtara ya ihe, o tinye onwe ya nʻọnọdụ onye na-akọ ya ma ghọta, nye onye ahụ ụsa ga-agbawa ya obi.	0
olee ụdịrị ede dị nʻala Igbo na ụfọdụ nri e jigasị ha  esi na adị mmadụ mma nʻahụ?	e nwere ede ji na ede ụlị nʻala Igbo. A na-ahụ ede ji nʻọkụ were mmanụ na ụkpaka rie ya. Ede ụlị ka e ji eme ụlị ofe, e jikwa ya asụ ụtara ede, were ya esi ede nhucha. E bee ede gbakpọọ, ọ wụrụ achịcha.	e nwere ede ji na ede ụlị nʻala Igbo. A na-ahụ ede ji nʻọkụ were mmanụ na ụkpaka rie ya. Ede ụlị ka e ji eme ogiri ofe, e jikwa ya asụ ụtara ede, were ya esi ede nhucha. E bee ede gbakpọọ, ọ wụrụ achịcha.	0
olee etu esi eme ngụ eji eme ọtụtụ ihe dị iche iche nʻala Igbo?	e gbutuo isi akwụ kpasịchaa akwụ, a hapụ ya ka ọ kpọọ, ọ kpọ́ọ́, à kpọ́ọ̄ ya ọkụ, ọ jụọ oyi, e kponye na mkpọ. Mgbe ọ bụla ị chọrọ ngụ, ị kupụta ụfọdụ, ị gbanye ya mmiri, kpagharia, wepụ ahịhịa ma zara mmiri ya mee ihe ị chọrọ ime. 	e gbutuo isi akwụ kpasịchaa akwụ, a hapụ ya ka ọ kpọọ, ọ kpọ́ọ́, à kpọ́ọ̄ ya ọkụ, ọ jụọ oyi, e kponye na mkpọ. Mgbe ọ bụla ị chọrọ ngụ, ị kupụta ụfọdụ, ị gbanye ya mmiri, kpagharia, wepụ ahịhịa ma zara aja ya mee ihe ị chọrọ ime. 	0
ngụ bara oke uru nʻala Igbo anyị, mere e ji eji ya esi nri dịgasị iche iche, i ma atụ:	e ji ngụ esi ụkwa maka na ọ na-eme ka ụkwa ghee ngwa ma tọkwa ụtọ pụrụ iche. E jikwa ngu agba ncha na ụkpa e ji agwọ abacha. Ụfọdụ na-etinye akanwụ nʻọnọdụ ngụ mana ndị dibia bekee abaala mba maka ya.	e ji ngụ esi ụkwa maka na ọ na-eme ka ụkwa ghee ngwa ma tọkwa ụtọ pụrụ iche. E jikwa ngu agba ncha na ụkpa e ji ebe abacha. Ụfọdụ na-etinye akanwụ nʻọnọdụ ngụ mana ndị dibia bekee abaala mba maka ya.	0
ilu Igbo sị na iwe nwanne anaghị eru nʻọkpụkpụ pụtara na : 	agbanyeghi ihe nwanne gị mere gị, ọ ka bụ nwanne gị mere ị ga-eji gbaghara ma kpofuo ihe ahụ. I nwere ike ị jụ enyi gị, gbaa nwunye gị alụkwaghịm mana o nweghi onye ga-anọchi nwanne mmadụ.	agbanyeghi ihe nwanne gị mere gị, ọ ka bụ nwanne gị mere ị ga-eji gbaghara ma kpofuo ihe ahụ. I nwere ike ị jụ enyi gị, gbaa nwunye gị alụkwaghịm mana o nweghi onye ga-anọchi enyi mmadụ.	0
kedu ihe kpatara nʻoge gboo, ụmụaka na-aka egwukọrịta egwu na-erikokwa nri nʻotu efere ma ọ dịghịzi nʻoge ugbu a?	a bịa n'oge ugbu a, ihe kpatara na ụmụaka ọgbara ọhụrụ anazighi egwukọrịta egwu otu ahụ bụ na ọtụtụ ihe nkiri dị nʻihe onyoonyoo na ekwentị anagharala ụmụaka mmasị ha. Ọzọ, ihe ọjọọ karịziri kịtaa, amakwaghị onye bụ onye.	a bịa n'oge ugbu a, ihe kpatara na ụmụaka ọgbara ọhụrụ anazighi egwukọrịta egwu otu ahụ bụ na ọtụtụ ihe nkiri dị nʻihe onyoonyoo na ekwentị anagharala ụmụaka mmasị ha. Ọzọ, ihe ọma karịziri kịtaa, amakwaghị onye bụ onye.	0
ikwanyere nwoke ugwu bụ agwa nwanyị ji ekechi di ya maka na:	o nweghi ihe tọrọ nwoke ụtọ ma nwunye na-akwanyere ya ugwu ruru ya ma na-egosipụta na nwoke ahụ na-agbalị nʻịchịkọta ezi na ụlọ ọnụ.	o nweghi ihe tọrọ nwoke ụtọ ma nwunye na-akwanyere ya ugwu ruru ya ma na-egosipụta na nwoke ahụ anaghị-agbalị nʻịchịkọta ezi na ụlọ ọnụ.	0
ịzụ nwa nwoke ka dị mfe karịa ịzụ nwa nwanyị ma ha na-etolite maka na:	nwa nwoke saa ahụ, ọ chịrị akwa ya yiri, rie nri, gawa akwụkwọ, o too, ọ chọwa akara aka ya mana nwanwanyị dị ka akwa ọkụkụ, ma egoo dị ya ma obi ọlụlụ mmiri. Ọ lụghị di o dị ka o nwere ihe ọjọọ ezi na ụlọ gị mere, ọ lụọ di, o si be gị pụọ zawa aha onye ọzọ.	nwa nwoke saa ahụ, ọ chịrị akwa ya yiri, rie nri, gawa akwụkwọ, o too, ọ chọwa akara aka ya mana nwanwanyị dị ka akwa ọkụkụ, ma egoo dị ya ma obi ọlụlụ mmiri. Ọ lụghị di o dị ka o nwere ihe ọjọọ ezi na ụlọ gị mere, ọ lụọ di, o si be gị pụọ zawa aha nne gị.	0
mgbe gboo, ụmụ ole mmadụ mụrụ na-egosipụta ụba na nkwanye ugwu tụmadụ ịmụ ọtụtụ nwoke mana ugbu a:	ndị mmadụ na-agbara ịmụta ọtụtụ ụmụaka ọsọ. Ahụghị ego eji eri nri ma ya fọdụ nke e ji akwụ ụgwọ akwụkwọ na nke e ji enyere ndụ aka.	ndị mmadụ na-agbara ịmụta ọtụtụ ụmụaka ọsọ. Ahụghị ego eji eri nri ma ya fọdụ nke e ji akwụ ụgwọ ọgwụ na nke e ji enyere ndụ aka.	0
ịlụ di abụghị isiokwu kama di ahụ o jikwa ihe e ji eme ka ezi na ụlọ bụrụ akwaa akwụrụ maka na:	nwoke ọ bụla chọrọ ịlụ nwanyị ga-ebu ụzọ lebara onwe ya anya mara ma ọ ga-anagidenwu omume nwanyị. Nke abụọ, a naa ya ego ọ ga-ewepụtakwa, nke atọ bụrụ ịma ihe inwe ezi na ụlọ na ndị ọgọ pụtara.	nwoke ọ bụla chọrọ ịlụ nwanyị ga-ebu ụzọ lebara ụlọ ya anya mara ma ọ ga-anagidenwu omume nwanyị. Nke abụọ, a naa ya ego ọ ga-ewepụtakwa, nke atọ bụrụ ịma ihe inwe ezi na ụlọ na ndị ọgọ pụtara.	0
alụm di na nwunye ruo mgbe ọnwụ bịara abụghị maka ụmụ ọgbara ọhụrụ ji ọwa ozi ịntaneetị mere ebe obibi maka na:	ọwa ozi ịntaneetị ejirila ozi nsogbo na ọnwụnwa ndị mmadụ na-enwe nʻezi na ụlọ ha  mebisie ezigbo obi na nlejere anya ndị mmadụ nwere ma na-elejere ụtọ alụm di na nwunye 	ọwa ozi ịntaneetị ejirila ozi nsogbo na ọnwụnwa ndị mmadụ na-enwe nʻezi na ụlọ ha  mebisie ajọ obi na nlejere anya ndị mmadụ nwere ma na-elejere ụtọ alụm di na nwunye 	0
 ụbụrụ ndị na-enwu ọkụ ma na-agafe ndị ọzọ nʻule niile adịghị ọchịchọ na mahadum maka na:	ọtụtụ nʻime ha abụghị ndị nkecha ma ọ bụ ndị agharịịgha. Ha na-abịa akwụkwọ nʻoge, na-ege ntị ma na-akpụkọ ihe niile onye nkuzi na-akụzi banyere isiokwu akpụ nʻọnụ.	ọtụtụ nʻime ha abụghị ndị nkecha ma ọ bụ ndị agharịịgha. Ha na-abịa akwụkwọ nʻoge, na-ege ntị ma na-akpụkọ ihe niile onye nkuzi na-akụzi banyere ahịrịokwu akpụ nʻọnụ.	0
ịkụzi nkụzi bụ ihe a na-agụrụ akwụkwọ ma kwado nke ọma tupu ị bawa klaasị ọ bụla maka na:	ịkwadoghị akwado, ị kọrọ gbagoo ị kọrọ gbadaa, o doo ụmụaka anya na ị kwadoghi isiokwu e nwere ụbọchị ahụ. Ọ bụ ya mere ọ ji dị mma ka ụlọ akwụkwọ ọ bụla nwee mpaghara na-enyochapụta ka ndị nkuzi si akụziri ụmụ akwụkwọ ihe.	ịkwadoghị akwado, ị kọrọ gbagoo ị kọrọ gbadaa, o doo ụmụaka anya na ị kwadoghi isiokwu e nwere ụbọchị ahụ. Ọ bụ ya mere ọ ji dị mma ka ụlọ akwụkwọ ọ bụla nwee mpaghara na-enyochapụta ka ndị nkuzi si egotere ụmụ akwụkwọ ihe.	0
iri nri azụtara nʻahịa di mfe maka na ị gaghị ata ahụhụ ị gaghị aga ahịa ihe nri ma ọ bụ gbaa okpofu isi ya mana: 	ọ dị mma iji aka gị sie nri ị ga-eri ka i were mara ihe i na-eri. Nri ahịa ana-atọka ma kpachachara anya ka ị ghara irite  ọrịa. Ị maghị ihe ejiri sie nri ahụ, ị makwaghị ka ebe anọrọ sie ya dịkwa.	ọ dị mma iji aka gị sie nri ị ga-eri ka i were mara ihe i na-eri. Nri ahịa ana-atọka ma kpachachara anya ka ị ghara irite ndụ. Ị maghị ihe ejiri sie nri ahụ, ị makwaghị ka ebe anọrọ sie ya dịkwa.	0
kedu uru ịba mba bara ma onye ị na-abara enwere obi na-akpọ gị iyi ma kpebie ime ihe masịrị ya?	oke mba adịghị mma ma ọ na-adịkwa mkpa mgbe ụfọdụ, iwe sụkọjuo gị obi, ị baa mba, kwuo ihe dị gị nʻobi, i nwere onwe gị, were ekpere sowe ndị fọdụrụ	oke mba adịghị mma ma ọ na-adịkwa mkpa mgbe ụfọdụ, iwe sụkọjuo gị obi, ị baa mba, chọọ ihe dị gị nʻobi, i nwere onwe gị, were ekpere sowe ndị fọdụrụ	0
ịgụ akwụkwọ na-atọ  ụfọdụ ndị ụtọ ma ọ bụrụ na o nwere ihe ntagharị ọnụ a na-etinye nʻọnụ mgbe a na-agụ akwụkwọ, ya mere:	ọ bụrụ nʻihe ntagharị ọnụ na-amasị gị ma ị na-agụ akwụkwọ, ị ga-achọ ihe di ka ahụkere ma ọ bụ ụ kwa eghere eghe, akị, ube okpoko na ihe ndị ọzọ gasị dowe ma ị chọọ ịgụ akwụkwọ	ọ bụrụ nʻihe ntagharị ọnụ na-amasị gị ma ị na-agụ akwụkwọ, ị ga-achọ ihe di ka ahụkere ma ọ bụ ụ kwa eghere eghe, akị, ube okpoko na ihe ndị ọzọ gasị dowe ma ị chọọ ịgụ egwu	0
ụmụaka ugbu a enweghizi nke na-achọ isi ma ọ bụ iri nri ụfọdụ e ji mara ndị Igbo pụtara na: 	ọtụtụ ezi na ụlọ anaghịzi esi ọna, ụkwa, ụtara ede, ede nhucha, ofe an̄ara, ji awaị, fịọfịọ. Ị hụ ezi na ụlọ a na-esi nri ndị a mara na o nwere onye ọrịa ma ọ bụ ezigbo okenye nọ ya maka na ụfọdụ ndị nne nwanyị amakwaghị ka e si esi ya. Naanị ezi na ụlọ ole na ole ka na-echekwawa nri ndi a.	ọtụtụ ezi na ụlọ anaghịzi esi ọna, ụkwa, ụtara ede, ede nhucha, ofe an̄ara, ji awaị, fịọfịọ. Ị hụ ezi na ụlọ a na-esi nri ndị a mara na o nwere onye ọrịa ma ọ bụ ezigbo nwata nọ ya maka na ụfọdụ ndị nne nwanyị amakwaghị ka e si esi ya. Naanị ezi na ụlọ ole na ole ka na-echekwawa nri ndi a.	0
mgbe mbụ naanị nwanyị ma ihe na-aga nʻusekwu na ngwa nri dị iche iche dị ya mana ugbu a:	nwoke na nwanyị na-abazi nʻime ma marakwa ihe ngwa nri dịgasị nʻusekwu. Onye buru ụzọ lata ọrụ, ọ baa usekwu chọọ ihe ọ ga-etinye nʻafọ. Ụfọdụ ụmụ nwoke na-agụ ihe gbasara usekwu na isi nri nʻakwụkwọ	nwoke na nwanyị na-abazi nʻime ma marakwa ihe ngwa nri dịgasị nʻugbo. Onye buru ụzọ lata ọrụ, ọ baa usekwu chọọ ihe ọ ga-etinye nʻafọ. Ụfọdụ ụmụ nwoke na-agụ ihe gbasara usekwu na isi nri nʻakwụkwọ	0
kedu ihe kpatara na a bịa nʻụlọ akwụkwọ ma ọ bụ nʻụlọ ụka, ụfọdụ ndị bi nso anaghị abịakarị nʻoge?	ihe kpatara ndị bi nso ejighi abịa n'oge bụ na ha na-eche n'obi ha na ha bi nso mere na ha anaghị ebido gboo kwadobe mana onye bi ebe tere aka na-ama ụzọ tete were gboo pụtawa ije ahụ	ihe kpatara ndị bi nso ejighi abịa n'oge bụ na ha na-eche n'obi ha na ha bi nso mere na ha anaghị ebido gboo kwadobe mana onye bi ebe di nso na-ama ụzọ tete were gboo pụtawa ije ahụ	0
ọgwụ e jizi agwọ nkwụkwụ nʻikpeazụ a abụghị mkpụrụ ọgwụ ma ọ bụ mmanya maka na:	ị chọta ego e ji ego mkpụrụ ọgwụ so n'ihe na-ebutezi ọbara mgbali elu. Ego e ji ego mmanya nọzikwa n'elu ọjị. Ihe nkiri ịntaneetị ka ndị mmadụ na-akwụzi obere ụgwọ wee na-ekiri, na-achị ma na-echezọtụ ihe mgbu ha	ị chọta ego e ji ego mkpụrụ ọgwụ so n'ihe na-ebutezi ọbara mgbali elu. Ego e ji ego mmanya nọzikwa n'elu ọjị. Ihe nkiri ịntaneetị ka ndị mmadụ na-akwụzi obere ụgwọ wee na-ekiri, na-achị ma na-echetatụ ihe mgbu ha	0
ezi na ụlọ ụfọdụ enweghi ihe ha ji ekpere kpọrọ, onye teta ọ gawara onwe ya mana:	a bịa n'ụfọdụ ezi na ụlọ, a na-eri ekpere ka nri, e teta ụra e kpee ekpere, tupu e riwe nri e kpee ekpere, ha na-ekpekwa ekpere ebe ọ bụla n'ime obi ha. E ruo oge e ji a rahụ ụra, onye ọ bụla agbakọọ, kelee Chineke.	a bịa n'ụfọdụ ezi na ụlọ, a na-eri ekpere ka nri, e teta ụra e kpee ekpere, tupu e riwe nri e kpee ekpere, ha na-ekpekwa ekpere ebe ọ bụla n'ime obi ha. E ruo oge e ji a rahụ ụra, onye ọ bụla agbasaa, kelee Chineke.	0
ebumnuche ụmụaka maka ihe ga-abụ n'ọdịniiru na-abụkarị ihe dị ka ọmarịcha nrọ maka na:	ọtụtụ ụmụaka na-an̄ụrụ aka ọrụ na-achaba n'anya dị ka dọkịta, nọọsụ, ọkwọ ụgbọ elu ma emechaa, mgbe ha malitere lelewe ule akwụkwọ dị iche iche ka ọtụtụ n'ime ha ga-achọpụta na mahadum abụghị maka ha. Ọtụtụ abanye ọrụ nkuzi. Naanị ndị tachiri obi ma nwee nne na nna dowere ego e ji azụ ha na-erute ebe ahụ ha chọrọ na ndị ụbụrụ ha meghere ụzọ	ọtụtụ ụmụaka na-an̄ụrụ aka ọrụ na-achaba n'anya dị ka dọkịta, nọọsụ, ọkwọ ụgbọ elu ma emechaa, mgbe ha malitere lelewe ule ejije dị iche iche ka ọtụtụ n'ime ha ga-achọpụta na mahadum abụghị maka ha. Ọtụtụ abanye ọrụ nkuzi. Naanị ndị tachiri obi ma nwee nne na nna dowere ego e ji azụ ha na-erute ebe ahụ ha chọrọ na ndị ụbụrụ ha meghere ụzọ	0
enyi nwoke na nwoke na-aga werewere karịa enyi nwanyị na nwanyị maka na:	Enyi nwoke na nwoke na-eme enweghi ogologo akụkọ, onye nọrọ n'ihe ụfụ, enyi ya asị ya jide obi ya aka, zụrụ mmanya zụnye ya. Mana enyi nwanyị  na nwanyị juru na ntụcha. Ha na-agbazi ihe enyi ha mere ha na nke o meere onye ọzọ. Ime enyi ụmụ nwanyị bụ ekworo enweghi ngwọta.	Enyi nwoke na nwoke na-eme enweghi ogologo akụkọ, onye nọrọ n'ihe ụfụ, enyi ya asị ya jide obi ya aka, zụrụ mmanya zụnye ya. Mana enyi nwanyị  na nwanyị juru na ntụcha. Ha na-agbazi ihe enyi ha mere ha na nke o meere onye ọzọ. Ime enyi ụmụ nwanyị bụ nghọta enweghi ngwọta.	0
ibinye mmadụ ego bụ ị chịrị ọkụ chịkwasị onwe gị mere ndị Igbo ji si na ọ bụghị ikunye enwe mmiri bụ isi kama ị nata ya iko, maka na:	ọtụtụ mmadụ enweela nsogbu ebe ha binyere ego kabie mgbe a ga-e ji kwụghachi ya na ụma dị ya n'elu, oge ruo akụkọ aka osemmiri n'ogo. Mmadụ bia mbibi ego, gba mbọ nye onye ahụ ego ị ga-anịnwu.	ọtụtụ mmadụ enweela nsogbu ebe ha binyere ego kabie mgbe a ga-e ji kwụghachi ya na ụma dị ya n'elu, oge ruo akụkọ aka osemmiri n'ogo. Mmadụ bia mbibi ego, gba mbọ nye onye ahụ ego ị gaghị anịnwu.	0
mmadụ enweghị ohere bụ na ihe ka mkpa abịabeghi, ya mere:	mgbe ọ bụla mmadụ na-aghagharị na o nweghi ohere, mara amara n'ihe onye ahụ na-eme mgbe ahụ ka ya mkpa karịa gị. I mee onwe gị ka ị dị mkpa, ndị mmadụ enye gị ohere na ndụ ha.	mgbe ọ bụla mmadụ na-aghagharị na o nweghi ohere, mara amara n'ihe onye ahụ na-eme mgbe ahụ ka ya mkpa karịa ha. I mee onwe gị ka ị dị mkpa, ndị mmadụ enye gị ohere na ndụ ha.	0
olee ihe ị ga-eme ka ị wee chụta ma keta oke gị n'ihe gbasara ihe akụ akụ na enwe enwe?	ị ga-akachite obi chibe iru n'ihe ị chọrọ ime, wepụ ihu nʻegwuregwu na oringo. I ga-abụ onye na-agba mbọ ma dịkwa ume ala n'obi. Ị yọọ Chineke ka ọ gọzie agbam mbọ gị.	ị ga-akachite obi chibe iru n'ihe ị chọrọ ime, wepụ ihu nʻegwuregwu na oringo. I ga-abụ onye na-agba mbọ ma dịkwa ume ala n'obi. Ị yọọ Chineke ka ọ gọzie ume ngwu gị.	0
ọ bụrụ na onye nkuzi chọọ ije n'ụlọ akwụkwọ, ihe ndị̣ o kwesiri itinye n'akpa ya bu:	ọ bụrụ na onye nkuzi chọọ ije n'ụlọ akwụkwọ, o kwesiri ịkwado ihe di iche iche dịka, nkpịsị odee, akwụkwo, akpa akwụkwọ ya na uwe ọ ga-eyi n'ahụ.	ọ bụrụ na onye nkuzi chọọ ije n'ụlọ akwụkwọ, o kwesiri ịkwado ihe di iche iche dịka, nkpịsị odee, akwụkwo, akpa akwụkwọ ya na efere ọ ga-eyi n'ahụ.	0
gịnị ka onye nwe ụlọ ga-eme iji were nabata onye bịara n'ụlọ ya?	Onye ọbia bịa na bee mmadụ, onye nwe ụlo ga-anabata ya site n'ichere ya ọjị, mmanya, achịcha ma ọ bukwa ibunye ya nri iji mee ka obi dị ya mma?	Onye ọbia bịa na bee mmadụ, onye nwe ụlo ga-anabata ya site n'ichere ya ọgụ, mmanya, achịcha ma ọ bukwa ibunye ya nri iji mee ka obi dị ya mma?	0
kedu  ihe ndị kwesiri na nwanyị chọrọ ịsa nwatakịrị amụrụ ọhụrụ ahụ na-akwadobe?	A bịa n’oge nwanyị chọrọ ịsa nwatakịrị amụrụ ohụrụ ahụ, ihe ndị o kwesiri i kwadobe gunyere ncha, mmiri ọkụ, mmiri oyi, ncha, akwa nhicha ahụ, ude, na mbọ isi	A bịa n’oge nwanyị chọrọ ịsa nwatakịrị amụrụ ohụrụ ahụ, ihe ndị o kwesiri i kwadobe gunyere ncha, mmiri ọbara, mmiri oyi, ncha, akwa nhicha ahụ, ude, mbọ isi	0
olee ihe mmadụ ga-eme iji hụ na akwa ya na-adị ọcha mgbe ọbụla?	Mmadụ ọbụla chọrọ ka akwa ya na-adị ọcha, ga na-eji nche na mmiri asu ya, ma kpasakwaa ya ka anwụ chaa ya, emesịa, o were igwe eji ede akwa were depịa ya nke ọma	Mmadụ ọbụla chọrọ ka akwa ya na-adị ọcha, ga na-eji ncha na mmiri asu ya, ma kpasakwaa ya ka anwụ chaa ya, emesịa, o were mmanụ eji ede akwa were depịa ya nke ọma	0
olee ihe nna maara ọrụ ya n'ezi na ulọ ga na-eme ka obi na-atọ ndị̣ ezi na ụlọ ya ụtọ mgbe niile?	nna maara ọrụ ya dịka isi n'ezi na ụlọ nwere ọtụtụ ihe di iche ọ na-eme iji mee ka obi na-atọ ezi na ụlọ ya ụtọ dịka, iwu ụlọ, ikpata nri, ịzụta uwe ngbochi, na iziga ụmụ ya ụlọ akwụkwọ	nna maara ọrụ ya dịka isi n'ezi na ụlọ nwere ọtụtụ ihe di iche ọ na-eme iji mee ka obi na-atọ ezi na ụlọ ya ụtọ dịka, iwu ụlọ, ikpata nsi, ịzụta uwe ngbochi, na iziga ụmụ ya ụlọ akwụkwọ	0
gịnị ka ị chere bu usoro ndị̣ mmadụ si echekwaba ego ha ka ọ dị tata:	ndị mmadụ nwere usoro di iche iche ha ji echekwaba ego ha dịka, itinye ya n'ụlọ akụ, inye ya ndị isusu, iji ya gbata ala	ndị mmadụ nwere usoro di iche iche ha ji echekwaba ego ha dịka, itinye ya n'ụlọ akụ, inye ya ndị isusu, iji ya gbata mmiri	0
ọ bụrụ na mmadụ chọrọ isi ịgbagbụ ọka ngwa nri ndị ọ ga-eji gunyere: 	ọ bụrụ na mmadụ chọrọ isi ịgbagbụ ọka ngwa nri ndị ọ ga-eji gụnyere: ọka, akwụkwọ ụma, ose, nnu, mmanụ, isha na mmiri. 	ọ bụrụ na mmadụ chọrọ isi ịgbagbụ ọka ngwa nri ndị ọ ga-eji gụnyere: ọka, akwụkwọ ụma, ose, nnu, mmanụ, isha na apịtị. 	0
kedu ka onye abacha na-agụ ga-esi were gwọta ya bụ abacha: 	Abacha na-agụ mmadụ, ọ ga-ebu ụzọ, zụta ya, banye ya na mmiri, sachaa ya nke ọma, suo ose, tinye ya nnu, azụ, mmanụ na ụgba were gwọgharịa ya	Abacha na-agụ mmadụ, ọ ga-ebu ụzọ, zụta ya, banye ya na mmiri, sachaa ya nke ọma, suo ose, tinye ya nnu, azụ, mmanụ na aja were gwọgharịa ya	0
olee otu m ga-esi sụọ akpụ m chọrọ iri n'anyasi tata, gwa m ka ya: 	onye bụla chọrọ ịsụ akpụ, ga-ebu ụzọ sinye mmiri n'ọkụ, mgbe ọsụrụ,  ọkpụnye akpụ n'ime ya rapụ ka ọsụgharịa, ịgụpụta ya, sụọ ya nke mbụ, tụnyegharịa nke ugboro abụọ, rapu ya ka osugharia ozo, ibutuo ya suzuo ya.	onye bụla chọrọ ịsụ akpụ, ga-ebu ụzọ sinye mmuru n'ọkụ, mgbe ọsụrụ, ịkpụnye akpụ n'ime ya rapụ ka ọsụgharịa, ịgụpụta ya, sụọ ya nke mbụ, tụnyegharịa nke ugboro abụọ, rapu ya ka osugharia ozo, o rie ya.	0
kọwara m ka m ga-esi mee ụlọ nke m ka ọ bụrụ sọ mma dịka nke ụnụ? 	usoro iji mee ka ụlọ  maa mma gụnyere ndị a: izacha ụlọ, idokwa oche niile nke ọma, isụchasi akwa mgbochi ọnụ ụzọ na kwa ihachasi ya mgbe dum	usoro iji mee ka ụlọ  maa mma gụnyere ndị a: izacha ụlọ, idokwa oche niile nke ọma, isụchasi akwa mgbochi ọnụ ụzọ na kwa ihachasi ya mgbe dum	0
gịnị bụ ihe ndị̣ i chere bụ ọru ụmụntakịrị n'ezi na ụlọ:	 ọrụ ụmụntakịrị n'ezi na ụlọ gụnyere ọtụtụ n'ime ndị a: ịsụ akwa, isi nri, ije ahia, ịsa efere, iku nwa na kwa ịza ụlọ	 ọrụ ụmụntakịrị n'ezi na ụlọ gụnyere ọtụtụ n'ime ndị a: ịsụ akwa, isi nri, ije ahia, ịma efere, iku nwa na kwa ịza ụlọ	0
kedu  ihe dị iche iche a ga-enweta na akwụ dịka bụ osisi bara ezi uru n'ala igbo, na ya dịka: 	akwụ bụ osisi bara ezi uru n'ala igbo, ihe dị iche iche ka a na-enweta na ya dịka: azịza, igu, akwụ, mmanụ, akị, abụbụ na ude akị	akwụ bụ osisi bara ezi uru n'ala igbo, ihe dị iche iche ka a na-enweta na ya dịka: azịza, igu, akwụ, mmanụ, akị, ikuku na ude akị	0
olee otu  esieji ogiri bụ ngwa nri pụrụ iche,  esi ọtụtụ nri n'ala Igbo 	ogiri bụ ngwa nri pụrụ iche, eji ya esi ọtụtụ nri dịka: ofe di iche gunyere onugbu, oha, egusi, nsala, achara	ogiri bụ ngwa nri pụrụ iche, eji ya esi ọtụtụ nri dịka: ofe di iche gunyere onugbu, oha, egusi, nsala, nsi	0
kedu ka akụrụ ngwa kwesiri na mmadụ chọrọ ka o wuo ụlọ elu na-azụta tupu ọ malite owuwu ụlọ ahụ	ọ bụrụ na mmadụ chọrọ ka o wuo ụlọ elu, akụrụ ngwa ndị o kwesiri ịzụta tupu ọ malite owuwu ụlọ ahụ gunyere: ala, aja, okwute, mmiri, okporo igwe, :	ọ bụrụ na mmadụ chọrọ ka o wuo ụlọ elu akụrụ ngwa ndị o kwesiri ịzụta tupu ọ malite owuwu ụlọ ahụ gunyere: ute, aja, okwute, mmiri, okporo igwe, :	0
mgbe agụrụ na-agụ mmadụ, kedu ihe ndị onwere ike iri iji belata ya:	mgbe agụrụ na-agụ mmadụ, ihe ndị o nwere ike iri iji belata ya bu: achịcha, ahụekere, ube, oroma, unere, ojoko	mgbe agụrụ na-agụ mmadụ, ihe ndị o nwere ike iri iji belata ya bu: achịcha, ahụekere, ure, oroma,	0
maka na akpịrị ịkpọ nkụ adịghị mma, ya bụ mgbe ọbụla nke a mere, mmadụ nwere ike: 	akpịrị ịkpọ nkụ adịghị mma, ya bụ mgbe ọbụla nke a mere, mmadụ nwere ike: ịnụ mmiri, ịnụ mmanya, ịta mkpụrụ osisi ndị nwere mmiri	akpịrị ịkpọ nkụ adịghị mma, ya bụ mgbe ọbụla nke a mere, mmadụ nwere ike: ịnụ mmiri, ịnụ mmanụ, ịta mkpụrụ osisi ndị nwere mmiri	0
kedu otu nwoke hụrụ nwa agbọghọbia ọ chọrọ ịlụ,  ga-esi bido ije a:	nwoke hụrụ nwa agbọghọbịa ọ chọrọ ịlụ,  ga-ebu uzo, jua ase gbasara ezi na ụlọ nwanyi ahụ, jee be nke nwanyi kụara ha aka, mee ego n'isi ya, gbaa nkwụ ma kpọrọ ya la bee ya	nwoke hụrụ nwa agbọghọbịa ọ chọrọ ịlụ,  ga-ebu uzo, jua ase gbasara ezi na ụlọ nwanyi ahụ, jee be nke nwanyi fere ha aka, mee ego n'isi ya, gbaa nkwụ ma kpọrọ ya la bee ya	0
gịnị mere ekwe ntị jiri bụrụ otu n'ime akụrụ ngwa onye ọbụla kwesịrị inwe nke aka ya:	ekwe ntị bụ otu n'ime akụrụ ngwa onye ọbụla kwesịrị inwe nke aka ya n'ihi na eji ya akpo oku ma zakwa, were ya edepu akwukwo ozi, were ya azu ma na-ere ahia, 	ekwe ntị bụ otu n'ime akụrụ ngwa onye ọbụla kwesịrị inwe nke aka ya n'ihi na eji ya akpo oku ma zakwa, were ya edepu akwukwo ozi, were ya azu ma na-ebe ahia	0
kedu ihe ụmụ mmadụ aghaghị ime arọ ọbụla tupu ha  akọnye ihe n'ala, :	arọ ọbụla tupu ụmụ mmadụ akọnye ihe n'ala, ha aghaghị ibu ụzo sụchaa ala, suo ahịhịa oku, gwuo olulu, ma chere ka mmiri ozuzu bịa.	arọ ọbụla tupu ụmụ mmadụ akọnye ihe n'ala, ha aghaghị ibu ụzo sụchaa ala, suo ahịhịa oku, gwuo olulu, ma chere ka mmiri ozuzu bie.	0
Olee  ihe ojiri bụrụ ihe kwesịrị ekwesi naonye ọbụla bu mmadụ iga na-edebe onwe ya ọcha na ndụ a:	mmadụ ịdị ọcha bụ ihe kwesịrị ekwesị na ndụ onye ọbụla n' ihi na ọ na-enye aka igbochi ọrịa di iche iche	mmadụ ịdị ọcha bụ ihe kwesịrị ekwesị na ndụ onye ọbụla n' ihi na ọ na-enye aka ibunye ọrịa di iche iche	0
olee  ji di iche iche onye diji bụ aha ana-akpọ nwoke igbo ọbụla mara ihe gbasara ịkọ na ichekwaba ji nwere ike ikọ:	Diji bụ aha ana-akpọ nwoke igbo ọbụla mara ihe gbasara ịkọ na ichekwaba ji di iche iche dịka ji ọcha, ji abi, ji abana, na ji ogbaagada	Diji bụ aha ana-akpọ nwoke igbo ọbụla mara ihe gbasara ịkọ na ichekwaba ji di iche iche dịka ji ọcha, ji abi, ji abana, na ji ogbaagada	0
mgbe ochie n'ala igbo, ha nwere ụzọ di iche iche esi agbasa ozi n'ime obodo ha dịka 	mgbe ochie n'ala igbo, ha nwere ụzọ di iche iche esi agbasa ozi n'ime obodo ha dika ikụ ogene, ima ekwe, ikụ ikoro, 	mgbe ochie n'ala igbo, ha nwere ụzọ di iche iche esi agbasa ozi n'ime obodo ha dika ikụ ogene, ima ekwe, ikụ aka, 	0
dibịa bekee n'ụlọ ọgwụ di iche iche na enwe ndị enyemeka iji kwado ha na:	dibịa bekee n'ụlọ ọgwụ di iche iche na enwe ndị enyemeka iji kwado ha na-ịkpọbata ndị ọria, inye ọgwụ, ịgba ọgwụ, ịwa afọ	dibịa bekee n'ụlọ ọgwụ di iche iche na enwe ndị enyemeka iji kwado ha na-ịkpọbata ndị ọria, inye ọgwụ, ịgba ọgwụ, ịwa afọ	0
mgbe ọbụla ndị mmadụ na apụ n'ụlọ ha, ha na-eji igodi tụchie ụzọ ha iji gbochie: 	mgbe ọbụla ndị mmadụ na apụ n'ụlọ ha, ha na-eji igodi tụchie ụzọ ha iji gbochie ndị ohi na ndị ọjọọ ibanye n'ụlọ ha.	mgbe ọbụla ndị mmadụ na apụ n'ụlọ ha, ha na-eji igodi tụchie ụzọ ha iji gbochie ndị ohi na ndị ọma ibanye n'ụlọ ha.	0
ndị na-ekpere arụsi dị iche iche na eji ọtụtụ ihe achụ aja dịka okpukpere ha kwuru dịka:	ndị na-ekpere arụsi dị iche iche na eji ọtụtụ ihe achụ aja dịka okpukpere ha kwuru dịka, ọkụkụ, ụgbala, ewu, atụrụ, nduru, ehi, awọ	ndị na-ekpere arụsi dị iche iche na eji ọtụtụ ihe achụ aja dịka okpukpere ha kwuru dịka, ọkụkụ, ụgbala, ewu, atụrụ, nduru, ehi, asọ	0
ọ bụrụ na mmadụ na-arịa arụ, o kwesiri ije ụlo ọgwụ ka ọ ga anọ n'ụlọ ya na-agwọ onwe ya:	ọ bụrụ na mmadụ na-arịa arụ, ọ bụ ihe kwesiri ekwesi na ọ ga-eje ụlo ọgwụ ka dibia bekee nyochaa ya ahụ	ọ bụrụ na mmadụ na-arịa arụ, ọ bụ ihe kwesiri ekwesi na ọ ga-eje ụlo ọgwụ ka dibia bekee nyawaa ya ahụ	0
olee ihe mere na ọtụtụ mmadụ na ekpe ekpere ma ha teta n'ụra n'ụtụtụ tupu ha agawa ọrụ ha dị iche iche:	ọtụtụ mmadụ na ekpe ekpere ma ha teta n'ụra n'ụtụtụ tupu ha agawa ọrụ ha dị iche iche n'ihi na ha kwenyere na chukwu bu ike ha. 	ọtụtụ mmadụ na ekpe ekpere ma ha teta n'ụra n'ụtụtụ tupu ha agawa ọrụ ha dị iche iche n'ihi na ha kwenyere na chukwu abụghị ike ha. 	0
kedu ọrụ ụmụ ntakiri nọ n'ezi n'ụlo kwesiri ịrụ iji nyere ndị nne na nna ya  aka:	ọrụ ụmụ ntakiri nọ n'ezi n'ụlọ kwesiri ịrụ iji nyere ndị nne na nna ya  aka gunyere ịza ụlọ, ịsụ akwa, ịsa efere, ikpo ahịhịa, ichu mmiri	ọrụ ụmụ ntakiri nọ n'ezi n'ụlọ kwesiri ịrụ iji nyere ndị nne na nna ya  aka gunyere ịza ụlọ, ịsụ akwa, ịsa efere, ikpo ahịhịa, ịgbafu mmiri	0
ọrụ aka dị  iche iche nke ụmụnwanyị na-alụ gụnyere otu nime ndị a: 	ọrụ aka dị  iche iche nke ụmụnwanyị na-alụ gụnyere otu nime ndị a, ịkwa akwa, ịkpa isi, ime achịcha, ighe akara, ịzụ ahia 	ọrụ aka dị  iche iche nke ụmụnwanyị na-alụ gụnyere otu nime ndị a, ịkwa akwa, ịkpa isi, ime achịcha, ighe akara, ịzụ aka	0
o kwesiri ka nwanyi ọ bụla bụrụ onye azụrụ nke oma n'ihi na:	o kwesiri ka nwanyi ọ bụla bụrụ onye azụrụ nke ọma n'ihi na ọ ga-enye aka ịzụlite ụmụ nke ya n'akwụkwọ, n'aka ọrụ, n'ibi ụlọ	o kwesiri ka nwanyị ọ bụla bụrụ onye azụrụ nke ọma n'ihi na ọ ga-enye aka ịzụlite ụmụ nke ya n'akwụkwọ, n'aka ọrụ, n'ire ụlọ	0
ọkụ bụ otu nime akụrụ ngwa na-enye ihe na ọchịrị ọchịrị ma na-esikwa nri, ma ọ bụrụ na mmiri gbasa ya:  	ọkụ bụ otu nime akụrụ ngwa na-enye ihe na ọchịrị ọchịrị ma na-esikwa nri, ma ọ bụrụ na mmiri gbasa ya mma ya na ike ya arụọ  	ọkụ bụ otu nime akụrụ ngwa na-enye ihe na ọchịrị ọchịrị ma na-esikwa nri, ma ọ bụrụ na mmiri gbasa ya mma ya na ike ya abaa  	0
nwata akwụkwọ ezigara ụlọ akwụkwọ nwere akparam agwa ọra mmadụ na-atụ anya n'ebe ọ nọ dịka:	nwata akwụkwọ ezigara ụlọ akwụkwọ nwere akparam agwa ọra mmadụ na-atụ anya n'ebe ọ nọ dịka ịmụta ihe karịa ka ọ dị na mbụ, ịsọpụrụ ndị tọrọ ya, ịmụta aka ọrụ dị iche iche	nwata akwụkwọ ezigara ụlọ akwụkwọ nwere akparam agwa ọra mmadụ na-atụ anya n'ebe ọ nọ dịka ichezọ ihe karịa ka ọ dị na mbụ, ịsọpụrụ ndị tọrọ ya, ịmụta aka ọrụ dị iche iche	0
gịnị ka nwa afọ igbo ọbụla kwesiri ime tupu  orie nri ụtụtụ: 	tupu nwa afọ igbo ọbụla erie nri ụtụtụ, atụrụ anya n'aka ya na ọ ga-ekpo ntụ abalị, zaa ezi na ụlọ, kpofuo ahịhịa ọ zatara n'ezi tupu o sie ihe ọbụla ọ chọrọ iri	tupu nwa afọ igbo ọbụla erie nri ụtụtụ, atụrụ anya n'aka ya na ọ ga-ese ntụ abalị, zaa ezi na ụlọ, kpofuo ahịhịa ọ zatara n'ezi tupu o sie ihe ọbụla ọ chọrọ iri	0
onye na-aga n'okporo ụzọ kwesiri ịkpachapụ anya n' ihi na ihe mberede okporo ụzọ nwere ike ịdapụta site na: 	onye na-aga n'okporo ụzọ kwesiri ịkpachapụ anya n' ihi na ihe mberede okporo ụzọ nwere ike ịdapụta site n'aka nri ma ọ bụ n'aka ekpe	onye na-aga n'okporo ụzọ kwesiri ịkpachapụ anya n' ihi na ihe mberede okporo ụzọ nwere ike ịdapụta site n'afa nri ma ọ bụ n'aka ekpe	0
ịnụbiga mmanya oke ma nke nwoke ma nke nwanyị jọọgburu onwe ya n' ihi na:	ịnụbiga mmanya oke ma nke nwoke ma nke nwanyị jọọgburu onwe ya n' ihi o nwere ike iduba mmadụ na ọnwụ ntụmadị	ịnụbiga mmanya oke ma nke nwoke ma nke nwanyị jọọgburu onwe ya n' ihi o nwere ike iduba mmadụ na ọnwụ ntụmadị	0
ịṅụ ọgwụ ike nwere ọtụtụ ihe ndakwasị na-eso ya nke gụnyere:	ịṅụ ọgwụ ike nwere ọtụtụ ihe ndakwasị na-eso ya nke gụnyere isi ngbaka, ịkwụ ụdọ, ọbara mgbali elu, igbu mmadụ	ịṅụ ọgwụ ike nwere ọtụtụ ihe ndakwasị na-eso ya nke gụnyere isi ngbaka, ịkwụ ụdọ, ọbara mgbali elu, ire mmadụ	0
ọ bụrụ na n' etiti ndụ, anyi nọ n' ọnwụ, ya mere na mgbe niile anyị na adị ndụ ka anyị gbanisie ike ime ka: 	ọ bụrụ na n' etiti ndụ, anyi nọ n' ọnwụ, ya mere na mgbe niile anyị na adị ndụ ka anyị gbanisie ike ime ka anyị na ibe anyị dị n'udo	ọ bụrụ na n' etiti ndụ, anyi nọ n' ọnwụ, ya mere na mgbe niile anyị na adị ndụ ka anyị gbanisie ike ime ka anyị na ibe anyị dị n'iro	0
abacha, a gwọrọ agwọ  nke bụ akpụ aghara agha bụ otu nime nri ndị igbo eji:	abacha, a gwọrọ agwọ  nke bụ akpụ aghara agha bụ otu nime nri ndị igbo a na-eji dịka: ose, ngụ, mmanụ, isha, akwụkwọ ụtazi agwọ	abacha, a gwọrọ agwọ  nke bụ akpụ aghara agha bụ otu nime nri ndị igbo eji: ose, ngụ, nkụ, isha, akwụkwo ụtazi were na akwodebe:	0
onye ọbụla chọrọ ịmatụ asụsụ ndị mba ọzọ, kwesiri idi uchu ma gbado anya n' akụkụ dị iche iche nke asụsụ ahụ dịka:	onye ọbụla chọrọ ịmatụ asụsụ ndị mba ọzọ, kwesiri idi uchu ma gbado anya n' akụkụ dị iche iche nke asụsụ ahụ dịka ịsụ asụ, ige ntị, ide ede na ịgụ agụmagụ	onye ọbụla chọrọ ịmatụ asụsụ ndị mba ọzọ, kwesiri idi uchu ma gbado anya n' akụkụ dị iche iche nke asụsụ ahụ dịka ịsụ asụ, ire ntị, ide ede na ịgụ agụmagụ	0
ndị ọrụ ugbo na-enwe mkpụrụ dị iche ha nwere ike ịkọ n' ubi gụnyere:	ndị orụ ugbo na-enwe mkpụrụ di iche ha nwere ike ịkọ n' ubi gụnyere: ọka, ọkwụrụ, ụgụ, ose, akịdị, ede, akpụ na ji	ndị orụ ugbo na-enwe mkpụrụ di iche ha nwere ike ịkọ n' ubi gụnyere: ọka, ọkwụrụ, ụgụ, ose, akịdị, eze, akpụ na ji	0
ọ bụrụ na mgbe mmadụ na-esi nri, mmanụ ọkụ nwere ike ịgwụnarị ya, mara na iji gbochie ọnọdụ a: 	ọ bụrụ na mgbe mmadụ na-esi nri, mmanụ ọkụ nwere ike ịgwụnarị ya, mara na iji gbochie ọnọdụ a, mmadụ kwesiri inwe ololo mmanụ ọkụ dị n'akụkụ	ọ bụrụ na mgbe mmadụ na-esi nri, mmanụ ọkụ nwere ike ịgwụnarị ya, mara na iji gbochie ọnọdụ a, mmadụ kwesiri inwe ololo mmiri ọkụ dị n'akụkụ	0
onye ọbụla nwere ụgbọ ala abụghị n'ihi na ọ bụ ọgaranya iri efi kama ọ bụ:	onye ọbụla nwere ụgbọ ala abụghị n'ihi na ọ bụ ọgaranya iri efi kama ọ bụ maka mkpa ọ na-egbo n'ụzọ dị iche iche	onye ọbụla nwere ụgbọ ala abụghị n'ihi na ọ bụ ọgaranya iri efi kama ọ bụ maka ara ọ na-egbo n'ụzọ dị iche iche	0
ọ bụghị nanị n' ịzụ mmadụ na mmahadum ka mmadụ ga eji bi ndụ zuru oke maka na:	ọ bụghị nanị n' ịzụ mmadụ na mmahadum ka mmadụ ga eji bi ndụ zuru oke maka na ọtụtụ ndị na-agaghị mmahadum na-ebi ndụ zuru oke	ọ bụghị nanị n' ịzụ mmadụ na mmahadum ka mmadụ ga eji bi ndụ zuru oke maka na ọtụtụ ndị na-agaghị mmahadum anaghị ebi ndụ zuru oke	0
emume erim ji bụ nnukwu ihe n' obodo dị iche iche n' ala igbo n' ihi na ọtụtụ ihe ngosi na-akpa obi anụrị ka a na-ego si dịka: ịgba mgba, ịgba egwu, iti mmọnwụ, ịgba bọọlụ	emume erim ji bụ nnukwu ihe n' obodo di iche iche n' ala igbo n' ihi na otụtụ ihe ngosi na-akpa obi anụrị ka a na-ego si dịka: ịgba mgba, ịgba egwu, iti mmonwụ, ịgba boolụ	emume erim ji bụ nnukwu ihe n' obodo dị iche iche n' ala igbo n' ihi na otụtụ ihe ngosi na-akpa obi anụri ka a na-ego si dịka: ịgba mgba, ịgba egwu, iti mmonwụ, ịgba boofụ	0
mmadụ ọbụla na-eri nri na-ebu ụzọ kwadobe ihe ndị ga-eme ka oriri ahụ gaa sịrịrị werere dịka:	mmadụ ọbụla na-eri nri na-ebu ụzọ kwadobe ihe ndị ga-eme ka oriri ahụ gaa sịrịrị werere dịka mmiri ịkwọ aka, mmiri ọnụnụ, na akwa nhicha aka	mmadụ ọbụla na-eri nri na-ebu ụzọ kwadobe ihe ndị ga-eme ka oriri ahụ gaa sịrịrị werere dịka mmanụ, ịkwọ aka, mmiri ọnụnụ, na akwa nhicha aka	0
ndị igbo nwere ụdịdị akwụkwọ nri di iche iche nke na-eme ka arụ na ndụ mmadụ gbasie ike ha gụnyere:	ndị igbo nwere ụdịdị akwụkwọ nri di iche iche nke na-eme ka arụ na ndụ mmadụ gbasie ike ha gụnyere mgbọrọdị, ụzịza, ụtazị, ụgụ, eriamịọnụ, ụgbọgụlụ	ndị igbo nwere ụdịdị akwụkwọ nri di iche iche nke na-eme ka arụ na ndụ mmadụ gbasie ike ha gụnyere mgbọrọdị, ụzịza, ụtazị, ụfụ, eriamịọnụ, ụgbọgụlụ	0
enwere ọtụtụ akpa dị iche iche dịka ọrụ ha na-arụ siri dị nke a gụnyere ndị a:	enwere ọtụtụ akpa dị iche iche dịka ọrụ ha na-arụ siri dị nke a gụnyere akpa aka, akpa ego, akpa akwa, akpa ọrụ, akpa nkwọnaazụ	enwere ọtụtụ akpa dị iche iche dịka ọrụ ha na-arụ siri dị nke a gụnyere akpa aka, akpa ego, akpa asa, akpa ọrụ, akpa nkwọnaazụ	0
onwenwe aka ji akụ n'ihi ihe nweta dị iche iche o nwere dịka: 	nwanne nne m bu aka ji akụ n'ihi ihe nweta di iche iche o nwere dịka: ụgbọ ala, ọdụ ahia dị iche iche, ụlọ di iche iche, ụlọ ndị ọbia na kwa ụlọ oriri na onụnụ	nwanne nne m bu aka ji akụ n'ihi ihe nweta di iche iche o nwere dịka: ụgbọ ala, ọdụ ahia dị iche iche, ụlọ di iche iche, ụlọ ndị ọbia na kwa ụlọ oriri na ọnọni	0
ọ bụrụ na ndị igbo kwuru si na mmiri bụ ndụ azụ, mmiri ataala, azụ anwụla, nke pụtara ihe na ndụ mmadụ n'ihi na:	ndị igbo kwuru si na mmiri bụ ndụ azụ, mmiri ataala, azụ anwụla, nke pụtara ihe na ndụ mmadụ n'ihi na onweghị onye ọbụla zuru oke naanị ya.	ndị igbo kwuru si na mmiri bụ ndụ azụ, mmiri ataala, azụ anwụla, nke pụtara ihe na ndụ mmadụ n'ihi na onweghị onye ọbụla zuru obe naanị ya.	0
osisi nkwụ bụ otu n'ime osisi akụkụ arụ ya niile bara uru nke a pụtara ihe n' ezie maka na:	osisi nkwụ bụ otu n'ime osisi akụkụ arụ ya niile bara uru nke a pụtara ihe n' ezie maka na esi na ya enweta azịza, akị, akpara, akpata, mmanụ, akwụ	osisi nkwụ bụ otu n'ime osisi akụkụ arụ ya niile bara uru nke a pụtara ihe n' ezie maka na esi na ya enweta azaza, akị, akpara, akpata, mmanụ, akwụ	0
aka aja aja na-ebute ọnụ mmanụ mmanụ, nke a pụtara na:	aka aja aja na-ebute ọnụ mmanụ mmanụ, nke a pụtara na onye rụọ, o rie.	aka aja aja na-ebute ọnụ mmanụ mmanụ, nke a pụtara na onye rụọ, o rie.	0
nwa ewu na-ata agba, nwa ya ana-ele ya anya n'ọnụ, okwu a dị ire n'oge a n' ihi na:	nwa ewu na-ata agba, nwa ya ana-ele ya anya n'ọnụ, okwu a di ire n'oge a n' ihi na akparam agwa nne na nna bụ nke ụmụaka na-enomi n'ụzọ niile ugbu a	nwa ewu na-ata agba, nwa ya ana-ele ya anya n'ọnụ, okwu a di ire n'oge a n' ihi na akparam agwa nne na nna bụ nke ụmụaka na-enomi n'ụzọ niile uti a	0
bunu bunu ibu anyị dannda bụ okwu ndị igbo nke na ezipụta na: 	bunu bunu ibu anyị dannda bụ okwu ndị igbo nke na ezipụta na mkpa dịrị otu onye, agbakọ aka gboo ya, ọ dịrị onye ahụ mfe.	bunu bunu ibu anyị dannda bụ okwu ndị igbo nke na ezipụta na mkpa dịrị otu onye, agbakọ aka gboo ya, ọ dịrị onye ahụ arọ.	0
ụbọchị satọdee na-abụ ụbọchị mkpocha na nzacha n' ọtụtụtụ ezi na ụlọ n' ihi ọtụtụ ọrụ dị iche gụnyere: 	ụbọchị satọdee na-abụ ụbọchị mkpocha na nzacha n' ọtụtụ ezi na ụlọ n' ihi ọrụ dị iche gụnyere ịsụ akwa, ihicha ụlọ, ịsa ụgbọ ala, isi nri, ije ahịa	ụbọchị satọdee na-abụ ụbọchị mkpocha na nzacha n' ọtụtụ ezi na ụlọ n' ihi ọrụ dị iche gụnyere ịsụ akwa, ihicha ụlọ, ịsa ụgbọ ala, isi nri, ije ahịa	0
nwanta ọbụla nwere obe nta ọ ga-ebu nke a pụtakarịchara ihe na ndụ ezi na ụlọ maka:	nke a pụtakarichara ihe na ndụ ezi na ụlọ makana  ka onye ọbụla nọ n'ezi na ụlọ nwere ọrụ o nwere ike irụ na-agbanyeghị ka ọ ra	nke a pụtakarichara ihe na ndụ ezi na ụlọ makana  ka onye ọbụla nọ n'ezi na ụlọ nwere ọrụ o nwere ike irụ na-agbanyeghị ka ọ tere	0
gịnị ka di na nwunye kwesịrị ime ka ezi n' ụlọ ha were na-ebi n' udo:	ihe di na nwunye kwesịrị ime ka ezi n' ụlọ ha were na-ebi n' udo bụ ịhụrịta onwe ha n'anya, iburịta ibu na-anyi ibe ha, ime ka ụmụ ha niile hara nha, ịkwụrụ n'ezi okwu mgbe ọbụla	ihe di na nwunye kwesịrị ime ka ezi n' ụlọ ha were na-ebi n' udo bụ ịhụrịta onwe ha n'anya, iburịta iro n'arụ ibe ha, ime ka ụmụ ha niile hara nha, ịkwụrụ n'ezi okwu mgbe ọbụla	0
kedu ka ụmụntakịrị ga-esi echekwaba ihe ha nwere n' ụlọ akwụkwọ:	ụmụntakịrị ga-echekwaba ihe ha nwere n' ụlọ akwụkwọ site n'ide aha ha na ya, ịkpachapụrụ ihe ha anya, ịkpọchi ihe ha n'ime igbe ha	 ụmụntakịrị ga-echekwaba ihe ha nwere n' ụlọ akwụkwọ site n'ide aha ha na ya, ịkpachapụrụ ihe ha anya, ịfesasị ihe ha nwere	0
kedu otu ezi na ụlọ ọbụla maara uru arụ isi ike baara ga-esi debe ụlọ mposi ha ọcha:	ezi na ụlọ ọbụla maara uru arụ isi ike baara kwesiri idebe ụlọ mposi ha ọcha site na iji aziza zaa ya, ma werekwazia ncha na asisa na-asa ya ubochi niile 	ezi na ụlọ ọbụla maara uru arụ isi ike baara kwesiri idebe ụlọ mposi ha ọcha site na iji aziza zaa ya, ma werekwazia ncha na asisa na-awa ya ubochi niile 	0
olee usoro kwesịrị ekwesi mmadụ ga-esi akpa ụmụ anụmanụ:	usoro kwesịrị ekwesi mmadụ ga-esi akpa ụmụ anụmanụ bụ inye ha nri mgbe o kwesiri, ịgba ha ọgwụ nakwa ịzachasị ụlọ ha	usoro kwesịrị ekwesi mmadụ ga-esi akpa ụmụ anụmanụ bụ inye ha nri mgbe o kwesiri, ịgba ha mmiri nakwa ịzachasị ụlọ ha	0
kedu ụfọdụ atụmatụ mmadụ kwesịrị igbaso iji hụ na o jere ọrụ n'oge ụbọchị ọbụla:	ụfọdụ atụmatụ mmadụ kwesịrị igbaso iji hụ na-ojere ọrụ n'oge ụbọchị ọbụla bụ iteta ụra n'oge, isi nri n'abalị, ịchịpụta akwa ọ ga-eyi n'abalị, idozi akpụkpọ ụkwụ na akpa ya tutu ọ rahụ ụra	ụfọdụ atụmatụ mmadụ kwesịrị igbaso iji hụ na-ojere ọrụ n'oge ụbọchị ọbụla bụ iteta ụra n'oge, isi nri n'abalị, ịchịpụta akwa ọ ga-eyi n'abalị, ire akpụkpọ ụkwụ na akpa ya tutu ọ rahụ ụra	0
ọ bụrụ na mmadụ chọrọ ka ọ ghara idabanye na nsogbu, o nwere ike ime otu a?	ka mmadụ ghara idabanye na nsogbu ọ ga-adị njikere ịjụ ajụjụ banyere ihe gbajuru ya anya ma nyochakwa ihe ọ bụla ọ chọrọ ime tupu o mee ya		0
ọbụrụ na ndị okenye ga-enwe ezi nchekwaba nakwazị arụ isi ike ndị nleta ha ga:	ọbụrụ na ndị okenye ga-enwe ezi nchekwaba nakwazị arụ isi ike ndị nleta ha ga-enwe obi ebere, umeala na ọmaiko n'arụ ha 	ọbụrụ na ndị okenye ga-enwe ezi nchekwaba nakwazị arụ isi ike, ndị nleta ha agaghị inwe obi ebere, umeala na ọmaiko n'arụ ha 	0
maka ịkwalite ezi akparamagwa n'etiti ụmụnne n'ezi na ulọ ọ bu ihe dị nkpa na: 	maka ịkwalite ezi akparamagwa n'etiti ụmụnne n'ezi na ulọ ọ bu ihe dị nkpa na nne na nna ga abụ ndị na-adịghị akpa oke n'etiti ụmụ ha, ndị na-asọpụrụ ibe ha		0
kedu etu mmadụ ga-esi gbanarị ọkụ ọgbụgba ọkachasị n'oge ọkọchị:	etu mmadụ ga-esi gbanarị ọkụ ọgbụgba ọkachasị n'oge ọkọchị bụ ịgbanyụ ọkụ mgbe ọbụla o sichara nri, ịkpachapụ anya ịhụ na ụmụntakịrị ejighị ọkụ egwu egwu	etu mmadụ ga-esi gbanarị ọkụ ọgbụgba ọkachasị n'oge ọkọchị bụ ịgbanyụ ọkụ mgbe ọbụla o sichara nri, ịkpachapụ anya ịhụ na ụmụntakịrị iji ọkụ egwu egwu	0
iji mee ka ụmụtakịrị na-amụta ihe ndi nkuzi na-akuziri ha n'ụlọ akwụkwọ, ndị nkuzi aghaghị:	iji mee ka ụmụtakịrị na-amụta ihe ndi nkuzi na-akuziri ha n'ụlọ akwụkwọ, ndị nkuzi aghaghị inwe ihe ngosi na-ezipụta ihe ha na-akụzi, ha ga-enwe ụzọ isi were nwalee ihe ha kuziri, ha aghaghị inwe ihe nrita iji gbaa ụmụ akwụkwọ ume, 	iji mee ka ụmụtakịrị na-amụta ihe ndi nkuzi na-akuziri ha n'ụlọ akwụkwọ, ndị nkuzi agaghị enwe ihe ngosi na-ezipụta ihe ha na-akụzi, ha ga-enwe ụzọ isi were nwalee ihe ha kuziri, ha aghaghị inwe ihe nrita iji gbaa ụmụ akwụkwọ ume, 	0
olee ihe enwere ike ime ka akwa asụrụ n'udu mmiri were kọcha nke ọma:	ihe enwere ike ime ka akwa asụrụ n'udu mmiri were kọchaa nke ọma bụ ịgba ụzọ were sụa akwa ahụ, ịpịchasị ya ike, ịgbasa ya n'ebe anwụ ma ọ bu ikuku ga na-eku ya, ịhụ na mmiri ozuzu amaghị ya	ihe enwere ike ime ka akwa asụrụ n'udu mmiri were kọchaa nke ọma bụ ite ụzọ were sụa akwa ahụ, ịpịchasị ya ike, ịgbasa ya n'ebe anwụ ma ọ bu ikuku ga na-eku ya, ịhụ na mmiri ozuzu amaghị ya	0
kedu ụzọ ndị nne na nna kwesiri ịbagide iji me ka ụmụ ha gbanarị ọria na agụụ n'ezi na ụlọ:	ụzọ ndị nne na nna kwesiri ịbagide iji me ka ụmụ ha gbanarị ọria na agụụ n'ezi na ụlọ bụ idebe gburu gburu ọcha, iji akwụkwọ nri esi nri n'ụzọ ọnatara chi 	ụzọ ndị nne na nna kwesiri ịbagide iji me ka ụmụ ha gbanarị ọria na agụụ n'ezi na ụlọ bụ edebeghị gburu gburu ọcha, iji akwụkwọ nri esi nri n'ụzọ ọnatara chi 	0
ọ bụrụ na udo na ọganihu ga-adị n' etiti ụmụnne, ndị nne na nna mụrụ ha kwesiri ikuziri ha:	ọ bụrụ na udo na ọganihu ga-adị n' etiti ụmụnne, ndị nne na nna mụrụ ha kwesiri ikuziri ha, otu ha ga-esi ebi n'udo, inyere ibe ha aka, ịbụ onye nche nwanne ha 	ọ bụrụ na udo na ọganihu ga-adị n' etiti ụmụnne, ndị nne na nna mụrụ ha kwesiri ikuziri ha, otu ha ga-esi ebi n'udo, inyere ibe ha aka, ịbụ onye ntisa nwanne ha 	0
gịnị bụ usoro ndị nne na nna kwesiri ịgbaso iji kwado ụmụntakịrị na eje akwụkwọ	usoro ndị nne na nna kwesiri ịgbaso iji kwado ụmụntakịrị na eje akwụkwọ bụ iteta n'oge sachaa ha arụ, mee ka ha gbaa ụzọ rie nri, dupụọ ha n'oge ma kwụọrọ ha ụgwọ akwụkwọ	usoro ndị nne na nna kwesiri ịgbaso iji kwado ụmụntakịrị na eje akwụkwọ bụ iteta n'oge sachaa ha arụ, mee ka ha ghara iri nri, dupụọ ha n'oge ma kwụọrọ ha ụgwọ akwụkwọ	0
ọ bụrụ maka ikuziere nwatakiri ka esi eme akamụ ndụ, ekwesiri inwe akụrụ ngwa dị ka:	maka ikuziere nwatakiri ka esi eme akamụ ndụ, ekwesiri inwe akụrụ ngwa dị ka efere, akamụ, mmiri oyi, mmiri ọkụ, ekwu ọkụ	maka ikuziere nwatakiri ka esi eme akamụ ndụ, ekwesiri inwe akụrụ ngwa dị ka efere, aka, mmiri oyi, mmiri ọkụ, ekwu ọkụ	0
dịka ji mmiri ọkụ bu otu n' ime nri nwanyị mụrụ nwa ọhụrụ na-eri, maka iji sie ya, ihe ndị a kwesiri ịdị:	dịka ji mmiri ọkụ bu otu n' ime nri nwanyị mụrụ nwa ọhụrụ na-eri, maka iji sie ya, ihe ndị  kwesiri ịdị bụ ji, ogiri, ụda, ose, ụzịza, ụtazị, azụ	dịka ji mmiri ọkụ bu otu n' ime nri nwanyị mụrụ nwa ọhụrụ na-eri, maka iji sie ya, ihe ndị  kwesiri ịdị bụ ji, ogo, ụda, ose, ụzịza, ụtazị, azụ	0
Ngwa nri nne nwanyị nke nwa ya mụrụ nwa na-akwado maka ibu jee bee ọgọ ya maka ọmụgwọ bụ: 	Ngwa nri nne nwanyị nke nwa ya mụrụ nwa na-akwado maka ibu jee bee ọgọ ya maka ọmụgwọ gụnyere: ji, azụ nkpọ, azụ okporoko, ịsha, ụda, ọkụkọ	Ngwa nri nne nwanyị nke nwa ya mụrụ nwa na-akwado maka ibu jee bee ọgọ ya maka ọmụgwọ gụnyere: wii, azụ nkpọ, azụ okporoko, ịsha, ụda, ọkụkọ	0
ọ bụrụ maka iji kwadoro ụmụaka iji hụ na ha kwụsịrị ịnyụ amịrị n'elu akwa ekwesiri:	ọ bụrụ maka iji kwadoro ụmụaka iji hụ na ha kwụsịrị ịnyụ amịrị n'elu akwa ekwesiri ime ka ha kwụsị ịnụ oke mmiri na mgbede,ime ka ha nyụọ amịrị tupu ha edina ala,  ịkwụ ha n'ime anyasị	ọ bụrụ maka iji kwadoro ụmụaka iji hụ na ha kwụsịrị ịnyụ amịrị n'elu akwa ekwesiri ime ka ha kwụsị ịnụ oke mmiri n'ụtụtụ, ime ka ha nyụọ amịrị tupu ha edina ala,  ịkwụ ha n'ime anyasị	0
Akụrụngwa eji edu nwagbọghọ na-eje na be di ya iji bido ụlọ nke aka ya gunyere:	Akụrụngwa eji edu nwagbọghọ na-eje na be di ya iji bido ụlọ nke aka ya gunyere ụgbọ ala, ọgọ, eku, ikwe, ọkwa, osi ite, ite, efere, akwa nwa	Akụrụngwa eji edu nwagbọghọ na-eje na be di ya iji bido ụlọ nke aka ya gunyere ụgbọ ala, ụkwụ, eku, ikwe, ọkwa, osi ite, ite, efere, akwa nwa	0
olee erimeri dị iche iche a na-esi n' ụbọchị ana-eme emume alụm di na nwunye bụ:	erimeri dị iche iche a na-esi n' ụbọchị ana-eme emume alụm di na nwunye bụ osikapa, abacha, akpụ, ji, ofe dị iche iche, ụgba, agharaagha	olee erimeri dị iche iche a na-esi n' ụbọchị ana-eme emume alụm di na nwunye bụ osikapa, abacha, akpụ, ji, ofe dị iche iche, ụgba, agharaagha	0
ụdụdị akparamagwa ụmụaka azụlitere nke ọma na akpaso ndị okenye gụnyere:	ụdụdị akparamagwa ụmụaka azụlitere nke ọma na akpaso ndị okenye gụnyere irube isi, ikele ndi tọrọ ha, inyere ndị okenye aka ibu ibu	ụdụdị akparamagwa ụmụaka azụlitere nke ọma na akpaso ndị okenye gụnyere inupụ isi, ikele ndi tọrọ ha, inyere ndị okenye aka ibu ibu	0
gịnị bụ ụfọdụ omume dị iche iche ụmụ ntakiri apụghị inwezuga onwe ha na ya bụ ndị a:	ụfọdụ omume dị iche iche ụmụ ntakiri apụghị inwezuga onwe ha na ya bụ ndị a: izu ori, ịgba asịrị, ibu iro, ịrọ otu, ịkwa emo, ịgba ama ụgha	ụfọdụ omume dị iche iche ụmụ ntakiri apụghị inwezuga onwe ha na ya bụ ndị a: izu ori, ịgba asa, ibu iro, ịrọ otu, ịkwa emo, ịgba ama ụgha	0
maka ihe onye ọkwụ ụgbọ ala kwesiri ime n'ụtụtụ ọbụla iji hụ n'ụgbọala dịka a chọrọ bụ: 	maka ihe onye ọkwụ ụgbọ ala kwesiri ime n'ụtụtụ ọbụla iji hụ n'ụgbọala dịka a chọrọ bụ: ịgbanye mmiri n'ụgbọ ala ya, ilele mmanụ ụgbọ ala ya, ịsacha ụgbọ ala ya ka ọ di mma		0
maka nwa akwụkwọ na-ejikere ile ule akwukwọ, ihe ndị ka ọ na-aghaghị ime:	maka nwa akwụkwọ na-ejikere ile ule akwukwọ, ihe ndị ọ na-aghaghị ime bụ: ibido n'oge amalitere kuzibe ihe na-agụgharị ya, ịjụ ajụjụ banyere ihe siri ya ike na nghọta, ikwenye na o nwere ike ịgafe n'ule ọ gaje ile	maka nwa akwụkwọ na-ejikere ile ule akwukwọ, ihe ndị ọ na-aghaghị ime bụ: ibido n'oge amalitere kuzibe ihe na-agụgharị ya, ịjụ ajụjụ banyere ihe siri ya ike na nghọta, ikwenye na o nwere ike ịgafe n'ule ọ gaje ile	0
kedu ihe mmadụ aghaghị ime iji hụ n'ụmụ ha abụghị ndị na-asa ụsa ihe ha na-enweghị:	ihe mmadụ aghaghị ime iji hụ na ụmụ ha abụghị ndị na-asa ụsa gụnyere ndị a, ịkụziri ha ka ha nwee afọ ojuju n'ihe ha nwere, inye ha ihe oriri mgbe o kwesiri, ịgwa ha na ọnwụ mberede nwere ike izute ha n'ọnọdụ dị otu a	ihe mmadụ aghaghị ime iji hụ na ụmụ ha abụghị ndị na-asa ụsa gụnyere ndị a, ịkụziri ha ka ha nwee afọ ojuju n'ihe ha nwere, inye ha ihe oriri mgbe o kwesiri, ịgwa ha na ọnwụ mberede nwere ike izute ha n'ọnọdụ dị otu a	0
kedu ihe mmadụ kwesiri ime iji hụ na ọ na-echekwaba akụ na ụba maka ụbọchi nkpa:	ihe mmadụ aghaghị ime iji hụ na ọ na-echekwaba akụ na ụba ya maka ụbọchi nkpa gụnyere: ịkwụsị oke oriri, ịhapụ ịzụ ihe ọ bụla ọ hụrụ, inwe afọ ojuju n'ihe o nwere, ịnwe nghọta na mmadu agaghị ericha akụ ya n'ọnụ	ihe mmadụ aghaghị ime iji hụ na ọ na-echekwaba akụ na ụba ya maka ụbọchi nkpa gụnyere: iri oke oriri, ịhapụ ịzụ ihe ọ bụla ọ hụrụ, inwe afọ ojuju n'ihe o nwere, ịnwe nghọta na mmadu agaghị ericha akụ ya n'ọnụ	0
ọ bụrụ na mmadụ achọghị ibu ibu, usoro ndị ọghaghị ịgbaso iji gbanarị nke a bụ ndị a:	ọ bụrụ na mmadụ achọghị ibu ibu, usoro ndị ọghaghị ịgbaso iji gbanarị ibu ibu: ịkwụsị iri ihe ọtọọ rịrịrị, ịkwụsị nri ime abalị, ịgba ọsọ opekata mpe ugboro abụọ n'izu ụka	ọ bụrụ na mmadụ achọghị ibu ibu, usoro ndị ọghaghị ịgbaso iji gbanarị ibu ibu: iri ihe ọtọọ rịrịrị, ịkwụsị nri ime abalị, ịgba ọsọ opekata mpe ugboro abụọ n'izu ụka	0
Kedu ka mmadụ ga-esi sie osikpa maka ezi na ụlọ ya kwesịrị inwe n'aka ya tupu obido: 	mmadụ ọ bụla chọrọ isi osikpa maka ezi na ụlọ ya aghaghị ịkwadobe ngwa nri dị iche iche dịka osikapa, ose, nnu, azụ, anụ, mmiri, mmanụ	mmadụ ọ bụla chọrọ isi osikpa maka ezi na ụlọ ya aghaghị ịkwadobe ngwa nri dị iche iche dịka osikapa, osa, nnu, azụ, anụ, mmiri, mmanụ	0
gịnị bụ ebumnuche mmadụ ji edebe gburugburu ya ọcha:	ebumnuche mmadụ ji edebe gburugburu ya ọcha bụ ihe ndị a: igbochi ọrịa, ịkwalite ezi arụ ike, idobe okiri ụlọ ọcha	ebumnuche mmadụ ji edebe gburugburu ya ọcha bụ ihe ndị a: ikwalite ọrịa, ịkwalite ezi arụ ike, idobe okiri ụlọ ọcha	0
olee ihe bụ uru dị n'izụlite ụmụtakịrị nke ọma bụ otu n'ime ndịa: 	uru dị n'izụlite ụmụtakịrị nke ọma bụ otu n'ime ndịa: inwe ezi ọrụ, inyere ibe ha aka, ịsọpụrụ ndị mụrụ ha na ndị okenye	uru dị n'izụlite ụmụtakịrị nke ọma bụ otu n'ime ndịa: ere ezi ọrụ, inyere ibe ha aka, ịsọpụrụ ndị mụrụ ha na ndị okenye	0
maka ịhụ na ụmụaka na-aga n'okporo ụzọ inwe ike gbanarị ọdachi, ha aghaghị:	maka ịhụ na ụmụaka na-aga n'okporo ụzọ inwe ike gbanarị ọdachi, ha aghaghị ịgwa ha ka ha lee anya n'aka nri na n'aka ekpe tupu ọ gbafee ụzọ oyibo	maka ịhụ na ụmụaka na-aga n'okporo ụzọ inwe ike gbanarị ọdachi, ha aghaghị ịgwa ha ka ha lee eze n'aka nri na n'aka ekpe tupu ọ gbafee ụzọ oyibo	0
ọ bụrụ na mmadu tinye akụ na ụba ya n'ezi ọrụ ọ pụrụ ime otu n'ime ihe ndị a: iwu ụlọ, ịzụ ụmụaka na akwụkwọ, ịzụta ụgbọ ala, inyere ndị okenye aka	ọ bụrụ na mmadu tinye akụ na ụba ya n'ezi ọrụ ọ pụrụ ime otu n'ime ihe ndị a: iwu ụlọ, ịzụ ụmụaka na akwụkwọ, ịzụta ụgbọ ala, inyere ndị okenye aka	ọ bụrụ na mmadu tinye akụ na ụba ya n'ezi ọrụ ọ pụrụ ime otu n'ime ihe ndị a: imu ụlọ, ịzụ ụmụaka na akwụkwọ, ịzụta ụgbọ ala, inyere ndị okenye aka	0
kedu atụmatụ ụfọdụ aga agbaso iji hụ na ụmụntakịrị ga-agbanarị ọtụtụ ọrịa na-eso udu mmiri gụnyere: 	atụmatụ ụfọdụ a ga-agbaso iji hụ na ụmụntakịrị ga-agbanarị ọtụtụ ọrịa na-eso udu mmiri gụnyere: iyibe ha akwa mgbochi, ịnu mmiri nke ọma, iji mmiri ọkụ asa ahụ	atụmatụ ụfọdụ a ga-agbaso iji hụ na ụmụntakịrị ga-agbanarị ọtụtụ ọrịa na-eso udu mmiri gụnyere: iyibe ha akwa mgbochi, ire mmiri nke ọma, iji mmiri ọkụ asa ahụ	0
maka ịkwado nwagbọghọbia maka ịbụ ezigbo nwunye nyere di ya, nne ya aghaghị: 	maka ịkwado nwagbọghọbia maka ịbụ ezigbo nwunye nyere di ya, nne ya aghaghị ikuziri ya maka isi nri, idozi ụlọ, ịsụ akwa, ichekwa ụmụaka na di ya	maka ịkwado nwagbọghọbia maka ịbụ ezigbo nwunye nyere di ya, nne ya aghaghị ikuziri ya maka imebi nri, idozi ụlọ, ịsụ akwa, ichekwa ụmụaka na di ya	0
ndị igbo nwere ọtụtụ ofe ejiri mara ha, maka iji kwadobe isi ofe onugbu, ngwa nri aghaghị idi bụ:	ndị igbo nwere ọtụtụ ofe ejiri mara ha, maka iji kwadobe isi ofe onugbu, ngwa nri aghaghị idi bụ: onugbu, ogiri, nnu, ose, ede, azụ, anụ, mmanụ, mmiri	ndị igbo nwere ọtụtụ ofe ejiri mara ha, maka iji kwadobe isi ofe onugbu, ngwa nri aghaghị idi bụ: onugbu, ogiri, onu, ose, ede, azụ, anụ, mmanụ, mmiri	0
gịnị bụ ihe ọtụtụ mmadụ na-eme karịsị mgbe ha tetasịrị n'ụra ụtụtụ	ihe ọtụtụ mmadụ na-eme karịsị mgbe ha tetasịrị n'ụra ụtụtụ bụ ikpe ekpere, ịbụ abụ, ịta atụ, ịsaa ihu, ikele ndị ezi na ụlọ ya	ihe ọtụtụ mmadụ na-eme karịsị mgbe ha tetasịrị n'ụra ụtụtụ bụ ikpe ekpere, ịbụ abụ, ịta atụ, ịmaa ihu, ikele ndị ezi na ụlọ ya	0
kedu ụzọ mmadụ nwere ike isi nyere ibe ya aka na mgbe mkpa na enweghị obi abụọ:	ụzọ mmadụ nwere ike isi nyere ibe ya aka na mgbe mkpa na enweghị obi abụọ: bụ iwuru mmadụ ụlọ, ịkwụrụ mmadụ ụgwọ akwụkwọ, inye ndị mmadụ ọrụ	ụzọ mmadụ nwere ike isi nyere ibe ya aka na mgbe mkpa na enweghị obi abụọ: bụ igbachi mmadụ ụlọ, ịkwụrụ mmadụ ụgwọ akwụkwọ, inye ndị mmadụ ọrụ	0
ọ bụrụ na mmadụ chọrọ ịkụ mkpụrụ n'ubi, ọtụtụ mkpụrụ e nwere gụnyere:	ọ bụrụ na mmadụ chọrọ ịkụ mkpụrụ n'ubi, ọtụtụ mkpụrụ e nwere gụnyere: ọka, ọkwụrụ, inene, ụgụ, akị oyibo, oroma	ọ bụrụ na mmadụ chọrọ ịkụ mkpụrụ n'ubi, ọtụtụ mkpụrụ e nwere gụnyere: ọma, ọkwụrụ, inene, ụgụ, akị oyibo, oroma	0
gịnị ihe ọra mmadu ji mmiri eme n'ụlọ dị ọtụtụ  ndị a bụ ụfọdụ n' ime ha: 	ihe ọra mmadu ji mmiri eme n'ụlọ dị ọtụtụ  ndị a bụ ụfọdụ n' ime ha: maka ịṅụ aṅụ, iji saa akwa, isi nri, ihicha ụlọ, ịwụ ahụ	ihe ọra mmadu ji mmiri eme n'ụlọ dị ọtụtụ  ndị a bụ ụfọdụ n' ime ha: maka ịfụ anụ, iji saa akwa, isi nri, ihicha ụlọ, ịwụ ahụ	0
olee ihe eji eme ka ụmụntakịrị ka bidochara akwụkwọ ọhụrụ we na-esonye bụ:	ihe eji eme ka ụmụntakịrị ka bidochara akwụkwọ ọhụrụ we na-esonye bụ: itinye igwe onyonyoo, ịgụrụ ha egwu, igwuso ha egwu	olee ihe eji eme ka ụmụntakịrị ka bidochara akwụkwọ ọhụrụ we na-esonye bụ: itinye ire onyonyoo, ịgụrụ ha egwu, igwuso ha egwu	0
kedu usoro onye ọrụ ugbo na-agbaso iji kọpụta ji n'ubi ya bụ ndị a:	usoro onye ọrụ ugbo na-agbaso iji kọpụta ji n'ubi ya bụ ndị a: ịzụta mkpụrụ ji, tee ya ọgwụ, gbawaa ya, kọọ obo aga-esonye ya, sonye ya n'ala	usoro onye ọrụ ugbo na-agbaso iji kọpụta ji n'ubi ya bụ ndị a: iri mkpụrụ ji, tee ya ọgwụ, gbawaa ya, kọọ obo aga-esonye ya, sonye ya n'ala	0
olee ụfọdụ ihe eji amara ndị na-achọ ọganihu n'ime obodo ndị mmadụ bi na ya: 	ụfọdụ ihe eji amara ndị na-achọ ọganihu n'ime obodo ndị mmadụ bi na ya bụ ndị a: ịkwụ ụgwọ ụtụ isi, ichekwaba ngwa obodo, inyere ndị obodo aka	ụfọdụ ihe eji amara ndị na-achọ ọganihu n'ime obodo ndị mmadụ bi na ya bụ ndị a: ịgbanarị ụgwọ ụtụ isi, ichekwaba ngwa obodo, inyere ndị obodo aka	0
gịnị bụ ihe mmadụ kpatara ego n'ụwa nwere ike iji ya mepụta?	ihe mmadụ kpatara ego n'ụwa nwere ike iji ya mepụta gụnyere ndị a: iwu ụlọ akwụkwọ, iwu ụlọ ọgbakọ, inyere ụmụ ogbenye aka	ihe mmadụ kpatara ego n'ụwa nwere ike iji ya mepụta gụnyere ndị a: iwu ụlọ akwụkwọ, ire ụlọ ọgbakọ, inyere ụmụ ogbenye aka	0
Kedu otu mmadụ nwere ike isi mee ka nwatakịrị na-ebe akwa kwụsị?	otu mmadụ nwere ike isi mee ka nwatakịrị na-ebe akwa kwụsị gụnyere: ịkwọ ya n'azụ, inye ya nri, ịgụrụ ya egwu, ịsa ya arụ, ikunye ya nne mụrụ ya.	otu mmadụ nwere ike isi mee ka nwatakịrị na-ebe akwa kwụsị gụnyere: ịkwọ ya n'azụ, ife ya nri, ịgụrụ ya egwu, ịsa ya arụ, ikunye ya nne mụrụ ya.	0
olee anụ dị iche iche mmadụ nwere ịkpa n'ụlọ be ya nke n'adịghị enye mmadụ nsogbu gụnyere otu n'ime ndị a:	anụ dị iche iche mmadụ nwere ịkpa n'ụlọ be ya nke n'adịghị enye mmadụ nsogbu gụnyere otu n'ime ndị a: nkịta, nwamba, oke oyibo, ewu, atụru, ịnyịnya	anụ dị iche iche mmadụ nwere ịkpa n'ụlọ be ya nke n'adịghị enye mmadụ nsogbu gụnyere otu n'ime ndị a: oyịta, nwamba, oke oyibo, ewu, atụru, ịnyịnya	0
gịnị bụ erimeri ụfọdụ nwanyị chọrọ ka ọ kwụsị nwatakịrị ara nwere ike inye nwa :	erimeri ụfọdụ nwanyị chọrọ ka ọ kwụsị nwatakịrị ara nwere ike inye nwa ya bụ akamụ, osikakpa, ji, ede, mmiri ara ehi	erimeri ụfọdụ nwanyị chọrọ ka ọ kwụsị nwatakịrị ara nwere ike inye nwa ya bụ akamụ, osopa, ji, ede, mmiri ara ehi	0
Ekele ụtụtụ. Depụta otù okwu e ji e kele mmadụ n’ụtụtụ.	Ịpụtala ụra / Ịbọọla chi, Isaala chi?	Ịbọọla chi. Ịpụtala ụra, Ịsaala chi, Jisie ike?.	0
Ịsụ mmanụ nkwụ. Kọwaa ka esị emepụta mmanụ nri.	Gbuo nkwụ, kee nkwụ, tụtụọ nkwụ, sie ya, sụọ ya, tụọ ya ma pata mmanụ.	 Gbuo nkwụ, kee nkwụ, tụtụọ nkwụ, sie ya, sụọ ya, tụọ ya ma pata mmanụ, wụnye n’ọkụ..	0
Igbu ọkụkọ màkà oriri. Kedu màkà ịkwado ọkụkọ màkà oriri?	Gbuo ọkụkọ, mesia ya, gbujaa ya ma sie ya màkà oriri.	Gbuo ọkụkọ, emesịla ya gbujaa ya màkà oriri.	0
Egwuregwu: Gịnị mere Onye isi ụlọ akwụkwọ pịara ụmụaka Ihe	Màkà ịlụ ọgụ n’ụzọ mgbè ha na-abịa akwụkwọ.	Màkà ha Jere kirie Mmanwụ mgbe há na-abịa akwụkwọ.	0
Mgba. Kedu ebe anyị jere mgba n'afọ a?	Anyị jere mgba n’Ọba n'afọ a.	Anyị jere mgba n’Owere n'afọ a.	0
Arụmarụụka. Gịnị mere ụmụaka jiri bịa n’azụ oge?	Ha na-egwuri egwu n’ụzọ ụlọ akwụkwọ .	Ha na-akpa nkata onye ka ike.	0
Ọmụmụ asụsụ Igbo. Kedu ihe nne na nna  ga-eme ka asụsụ Igbo gaa n’ihu ?	Ha gana –akuziri ụmụ ha asụsụ Igbo mgbe niile .	Há ga-enye ụmụ ha ego màkà asụsụ Igbo.	0
Ịdịnotu : Gịnị na -ebute ịdịnotu n’obodo?	Ịgbakọọ agbakọọ nyụo mamịrị ya agbọọ ụfụfụ	Ịgbakọọ agbakọọ nyụo mamịrị ya abụrụ nsogbu obodo.	0
isi nri. Kọwaa ka e si esi osikapa.	Ụgochị sara osikapa sie ya n’ọkụ.	Ugochi sara agwa sie ya n’ ọkụ.	0
Ísî anụ. Kedu ka e si esi anụ ezi?	Nne m maara ka e si esi anụ ezi nke ọma.	Nne m maara ka e si esi anụ nkịta nke ọma.	0
Isi ofe. Olee ka esị eji ụsụ esi ofe ?	Nwanne m sụrụ ụsụ jiri ya sie ofe egusi.	Nwanne m sụrụ ụsụ jiri ya sie ofe akịdị	0
Nkwado Ule. Olee ihe ndị nne na nna na ndị nkuzi gwara anyị?	Ha gwara anyị gụsie akwụkwọ ike nke ọma tupu anyị e lee ule Sekọndịrị ukwu.	Ha gwara anyị gụsie akwụkwọ ike nke ọma ka anyị daa n’ ule.	0
Isi ji Kedu ụzọ dị iche ichè e si esi ji?	Ana-esi ya esi, hụọ ya n’ọkụ jiri mmanụ ghee ya eghee.	Ana -esi ya esi, hụọ ya n’ọkụ jírí mmanụ saa ya asaa.	0
Ịba n’ọhịa. Kedu ihe onye bara n’ọhịa na-ebute ?	Onye bara n’ọhịa na-ebute akụ, anụ, fote ero kpata ahịhịa nri, ghọtakwa mkpụrụ osisi.	Onye bara n’ọhịa na-ebute akụ, anụ, fote ero kpata ahịhịa nri lụkwaa ọgụ.	0
Ụgwọ onye ọrụ. Olee ihe ga-eme onye rụrụ ọrụ ?	Onye rụọ ọrụ ya erijuo afọ.	Onye rụọ ọrụ agụù egbuo ya.	0
Aka ọrụ. Kedu Aha m, Kedu ihe m na-eme?	Abụ m Ngọzi, ana m akuzi ihe ma na-erekwa ahịa.	Abụ m Udoka, ana m akuzi ihe na-erekwa ahịa.	0
Ofe. Kedu ihe Nne m tara?	Nne m tara azụ dị n’ime ofe ǹsàlà o siri.	Nne m tara azụ dị n’ofe ọgbọnọ o siri.	0
Ịga ụlọ Akwụkwọ. Kedu ka m siri jee Ụlọ akwụkwọ?	Agbara m ụgbọala jee ụlọ akwụkwọ Kuzie ihe, ma nye ụmụakwụkwọ arụmarụ.	Agbara m ụgbọala jee ụlọ akwụkwọ gwurịa egwu lọta.	0
Ịkwado nkuzi. Kedu ka e si akwado tupu akuzie ihe?	Ana - eme nchọcha, gụgharìa isiokwu tupu akuzie ihe.	Ana - eme nchọcha, chefuo isiokwu tupu akuzie ihe.	0
Ọrụ ubi. Kedu ihe ị kọrọ n’ubi gị? 	Arụrụ m ọrụ ubi n’azụ ụlọ m ebe m kọrọ ji, ede na akpụ.	Arụrụ m ọrụ ubi n’azụ ụlọ m ebe m kọrọ ego n’ala.	0
Ezumiike. Kedu ihe ụmụ gị mere n’ezumiike a?	Ụmụ m lọtara ezumiike nyeere m aka sụchaa ahịhịa nọ n’azụ ụlọ.	Ụmụ lọtara ezumiike meteere m ókòró na ọghọm n’oge a.	0
Idobe obodo ọcha. Kedu ihe mere obodo jiri gbakọọ?	Ndị obodo gbakọrọ màkà isụchasị na ịzachasị mbara ámá ha.	Ndị obodo gbakọrọ màkà oriri na nkwari na mbara ámá ha.	0
Nzụlite ụmụ nwaanyị. Kedu ka ụmụ nwaanyị sị azulite ụmụ ha ndị nwaanyị?	Ha na-akuziri ha ka ha zachasia ụlọ, sie nri, gaa ọrụ ubi, lekọta ụmụ nne ha ndị nta anya.	Ha na-akuziri ha ka ha zachasia ụlọ, sie nri, gaa ọrụ ubi, na-apị ekwentị ha.	0
Ọrụ ndị ntorọbịa. Kedu aka ọrụ ndị ntorọbịa kwesịrị ịmata?	Ha kwesịrị ịmata aka ọrụ dị iche ichè e si akpata ego, mepụta ihe ahụrụ anya .	Ha kwesịrị ịbata aka ọrụ dị iche iche na-añụgharị mmanya n’obodo.	0
Ọzụzụ ndị ọchịchị. Kedu ihe ndị ọchịchị ga- emere ndị ntorobịa?	Ha amalitela ịzụlite ndị ntorọbịa n’aka ọrụ dị iche ichè dị ka imepụta ágbá na itinye ọkụ sola.	Ha amalitela ịzụlite ndị ntorobịa n’aka ọrụ dị iche ichè dị ka ímē mpụ n ịgwọ ọgwụ.	0
Ị́zụ ụmụ n’aka ọrụ. Kedu ọrụ aka dí nà nwunye kwesịrị ịzupụta ụmụ ha nà ya?	Ha na -azụpụta ha n’ọrụ dị ka ịkwa Akwa, iteji ụlọ, ịrụpụta agba, ọrụ kọmputa na ntaneti, ịkụpụta mkpụrụ okwu n’igwe, ịzụ ahịa.	Ha na -azụpụta ha n’ọrụ dị ka ịkwa Akwa, iteji ụlọ, ịrụpụta agba, ọrụ kọmputa na ntaneti, ịkụpụta mkpụrụ okwu n’igwe, ịzụ ahịa na ịzụ ohi.	0
Isi àgwà. Kedu ka ụnụ si esi agwa?	Ana -ebu ụzọ họchaa ya aja na ihe n’adighị mma, saa ya mmiri sinye n’ite, ya gbọọ afọpụta ya wụpụ mmiri ọjọọ saa ya ọzọ sinye n’ọkụ ruo mgbe ọ ghere.	Ana – ahọ ya aja sinye ya etu ahụ n’ọkụ.	0
Ilekọta nwa ọhụrụ. Kedu ihe méré nwaanyị mụrụ nwa ohụru ji enye ya mmiri ara ya?	Ka ọ gbasie ike, gbochie ọrịa ma na-eto eto.	Ka ọ gbasie ike, gbochie ọrịa ghara ịtọ eto.	0
Nri ụtụtụ. Gịnị ka I riri n’ụtụtụ taa?	E riri m ji, taa akwa e siri esị, ṅụọ tii ọkụ n ‘ụtụtụ taa.	E riri m ji taa akwa eghere eghe ñụọ tii ọkụ taa.	0
Nleta ndị Ọchịchị. Olee onye lụrụ ọgụ taa n’ahịa?	Udoka lụrụ ogụ n’ahịa mgbe ndị isi ọchịchị obodo anyị bịara nleta?	Udoka lụrụ ogụ n’ahịa mgbe ndị isi ọchịchị obodo anyị bịara igbu mmdụ?	0
Enyemaka. Gịnị ka onye ndu ha meere enyi ya nwoke?	Ọ bịara nyere enyi ya nwoke aka gwuo ala ili ńnà ya.	Ọ bịara nyere enyi ya nwoke aka gbuo ńnà yá.	0
Ọla Ada ézè. Olee ebe ha liri ọla ọcha Ada eze?	bụ n’oke ọhịa dị n’ obodo Ihemewe ka ha liri ya.	Ọ bụ n’ime ahịa dị n’ obodo Ihemewe ka ha liri ya.	0
Nkịta Ndụka. Onye gbajiri nkịta Ndụka ụkwụ?	Ọ bụ ụmụ okorọbịa ndị anwụrụ ike gbajiri ya ụkwụ.	Ọ bụ ụmụ okorobịa ndị anwụrụ ike gbagburu ya.	0
Kedu ihe méré nwoke ahụ jiri bàa mba ?	Ihe méré o jiri bàa mba bụ n’ihi ndị ihe ọma adịghị mma nyụtọrọ ụlọ ọgwụ ya na nsi na mamịrị.	Ihe mere o jiri bàa mba bụ n’ihi ndị ihe ọma adịghị mma mụrụ nwa n’ụlọ ọgwụ ya.	0
Nsogbu obodo. Gịnị butere ajụchaa a nara?	Ihe isi ike nke dị n’ obodo.	Ọnodụ akụnaụba dị n’obodo.	0
Igbo mkpa agụụ na ihe isi ike. Ọ bụ ginị butere nsogbu n’obodo taa?	Ụkọ ego, ụkọ ihe oriri, ọnọdụ ahụike.	Ụkọego, ụkọ ihe oriri na ndị okenye.	0
Kedu ụzọ esi agbanahụ agụụ na ahụ ọjọọ?	Kụọ ihe oriri dị iche iche na ahịhịa nri na mkpụrụ osisi na-enyere ndụ aka n’ubi.	Kụọ ihe oriri dị iche iche na ahịhịa nri na mkpụrụ osisi na-ebibi ndụ n’ubi.	0
Mmega ahụ. Kedu ụzọ ọzọ e si enwe ahụike n’abụghị nri?	Ụtụtụ niile m ga-eme mmega ahụ iji nwee ahụike.	Ụtụtụ niile m ga-eme mmega ahụ iji nwee ọrịa.	0
ihe Mmega ahụ. Olee ihe mmega ahụ ise ị maara?	Ịgba ọsọ, ife aka, ịnyagharị ahụ, ịgba ígwè, iwuli elu, ịgasi ije ike, ịgbatị ụkwụ na áká.	Ịgba ọsọ, ife aka, ịnyagharị ahụ, ịgba ígwè, iwuli elu, ịgasi ije ike, ịnụ oke mmanya.	0
Inwe ahụike mgbe dum. Kedu ihe ịga- eme maka ahụike mgbe dum?	Ị ga -ejisi ike na -ewepụ oké echiche na ndụ gị, rie ezigbo nri ma zuo okè.	Ị ga -ejisi ike na -eche oké echiche na ndụ gị, rie ezigbo nri ma zuo okè.	0
ihe nwata ga- eme. Gịnị ka nwata chọrọ ímé nke ọma n’ule ga-eme?	Ọ ga-aga akwụkwọ n’oge, gee ntị n’ihe ndị nkuzi ya na-akuzi, rụọ ọrụ ụlọ ya gụsie akwụkwọ ike tupu oge ule eruo.	Ọ ga-aga akwụkwọ n’oge, gee ntị n’ihe ndị nkuzi ya na-akuzi, rụọ ọrụ ụlọ ya kwụsị igụ akwụkwọ tupu oge ule eruo.	0
Ịbara nwata mba. Onye ka ọ dịrị ịbara nwata isiike mba?	Nne na nna ka ọ dịịrị ịbara nwa ha mba ma ọ bu tie ya ihe mgbe ọ na-emegheri.	Nne na nna ka ọ dịịrị ịsị nwa ha ndewo ma ọ bu zụtara ya ihe mgbe ọ na-emegheri.	0
Asụsụ olunne. Kedu mgbe kà mmá ikuziri nwata asụsụ olunne?	Site na nwata, mgbe a na-akọ akụkọ, eme ihe n’ụlọ.ige ntị, ile anya n’ọnụ.	Site na nwata, mgbe a na-akọ akụkọ, eme ihe n’ụlọ.ige ntị, ile anya n’ọnụ.	0
Ịbara nwata mba. Kedu ụzọ nwata si amata na ihe ọ mere adịghị mma?	Mgbe a baara ya mbà, tie ya ihe kewọ ya oke.	Mgbe a baara ya mbà, tie ya ihe zụtara ya anụ.	0
Nkuzi omenaala na nsọpụrụ. Kedu ihe ńnà na-akuziri ụmụ ya ndị nwoke?	Nna na-akuziri ha omenaala na ụzọ esi asọpụrụ ndị okenye.	Nnà na-akuziri ha omenaala ná inupụrụ ndị okenye isi	0
nkuzi isi nri. Olee ụzọ esi egbochi ajọọ ite?	Ụmụ nwaanyị ịma ka e si esi nri ndị Igbo .	Ụmụ nwaanyị amụtaghị ka e si esi nri ndị Igbo .	0
Ịbara nwata mba. Kedu ụzọ e si agbazi ajọọ nwata ólú?	Aga-abara ya mbà, mee ka ọ kwụsị izu ohi, kwụsị ilụ ọgụ, ịgba arabanko n’ama na iso òtù ọjọọ.	Agaghị abara ya mbà, agaghị eme ka ọ kwụsị izu ohi, kwụsị ilụ ọgụ, ịgba arabanko n’ama na iso òtù.	0
Igbochi Agụụ. Kedu ụzọ esi egbo Agụụ dị n’obodo ?	Onye ọ bụla itinye isi n’ ọrụ ubi: jisie ike rụta ji, ede, ọka, ahịhịa nri, ose, otubo ala ga-enye aka gbochie agụụ.	Onye ọ bụla etinyela isi n’ ọrụ ubi:ejisila ike rụta ji, ede, ọka, ahịhịa nri, ose, otubo ala enyela aka gbochie agụụ.	0
Uru mkpụ̀rụ akụkụ ubi. Ụzọ e si enweta ego na mkpụrụ akụkụ ubi?	Aga-ere ha n’ahịa iji nweta ego aga-eji zuru ihe ndị ọzọ dị mkpa n’ụlọ .	Agaghị ere ha n’ahịa agaghị eji ha nweta ego aga-eji zuru ihe ndị ọzọ dị mkpa n’ụlọ .	0
Ụzọ mkpata ego. Olee uzọ e si akpata ego taa?	Ndị mmadụ na-esite n' àkà ọrụ dị ka ịkwa ákwà, ịrụ ụlọ, ọrụ ubi, ìzụ ahịa akpata ego.	Ndị mmadụ na-esite n’ àkà ọrụ dị ka ịkwa ákwà, ịrụ ụlọ, ọrụ ubi, ìzụ ahịa, ịlụ ogụ akpata ego.	0
Ngwa isi nri. Gịnị ka anyị ji esi nri?	Anyị ji ite, osiite, nkụ, ite igwe esi nri.	Anyị ji ite, osiite, nkụ, ite igwe asa ahụ.	0